"Circ/Dist and County","County Code","All FilingsTotal","All Filings Chap. 7","All Filings  Chap. 11","All Filings  Chap.12","All Filings Chap.13","Business Filings Total","Business Filings Chap.7","Business Filings Chap.11","Business Filings Chap.12","Business Filings Chap.13","Nonbusiness Filings Total","Nonbusiness Filings Chap.7","Nonbusiness Filings Chap.11","Nonbusiness Filings Chap.13","Bankruptcy Court"
MARICOPA,4013,1,1,0,0,0,0,0,0,0,0,1,1,0,0,"2ND  "
"SAN FRANCISCO",6075,1,1,0,0,0,0,0,0,0,0,1,1,0,0,"2ND  "
FAIRFIELD,9001,1903,1520,50,0,333,104,64,38,0,2,1799,1456,12,331,"2ND  "
HARTFORD,9003,1504,1244,15,0,245,63,45,12,0,6,1441,1199,3,239,"2ND  "
LITCHFIELD,9005,436,385,6,0,45,15,10,5,0,0,421,375,1,45,"2ND  "
MIDDLESEX,9007,292,253,1,0,38,12,11,0,0,1,280,242,1,37,"2ND  "
"NEW HAVEN",9009,1792,1429,18,0,345,52,34,17,0,1,1740,1395,1,344,"2ND  "
"NEW LONDON",9011,396,364,0,1,31,17,15,0,1,1,379,349,0,30,"2ND  "
TOLLAND,9013,193,164,5,0,24,10,3,5,0,2,183,161,0,22,"2ND  "
WINDHAM,9015,226,186,3,0,37,10,6,3,0,1,216,180,0,36,"2ND  "
BROWARD,12011,1,1,0,0,0,0,0,0,0,0,1,1,0,0,"2ND  "
MIAMI-DADE,12086,1,1,0,0,0,1,1,0,0,0,0,0,0,0,"2ND  "
CLAYTON,13063,1,1,0,0,0,0,0,0,0,0,1,1,0,0,"2ND  "
GWINNETT,13135,1,1,0,0,0,0,0,0,0,0,1,1,0,0,"2ND  "
HAMPDEN,25013,2,2,0,0,0,0,0,0,0,0,2,2,0,0,"2ND  "
MIDDLESEX,25017,1,0,0,0,1,0,0,0,0,0,1,0,0,1,"2ND  "
UNION,34039,1,1,0,0,0,0,0,0,0,0,1,1,0,0,"2ND  "
BRONX,36005,4,2,0,0,2,0,0,0,0,0,4,2,0,2,"2ND  "
NASSAU,36059,1,1,0,0,0,0,0,0,0,0,1,1,0,0,"2ND  "
"NEW YORK",36061,2,1,1,0,0,1,0,1,0,0,1,1,0,0,"2ND  "
PUTNAM,36079,1,1,0,0,0,0,0,0,0,0,1,1,0,0,"2ND  "
ROCKLAND,36087,1,1,0,0,0,1,1,0,0,0,0,0,0,0,"2ND  "
WESTCHESTER,36119,2,1,0,0,1,0,0,0,0,0,2,1,0,1,"2ND  "
KENT,44003,1,1,0,0,0,0,0,0,0,0,1,1,0,0,"2ND  "
WASHINGTON,44009,1,1,0,0,0,0,0,0,0,0,1,1,0,0,"2ND  "
AIKEN,45003,1,0,0,0,1,0,0,0,0,0,1,0,0,1,"2ND  "
HARRIS,48201,1,0,1,0,0,1,0,1,0,0,0,0,0,0,"2ND  "
"OUTSIDE HOME STATE",88888,1,0,1,0,0,1,0,1,0,0,0,0,0,0,"2ND  "
"OUTSIDE U.S.",99999,6,0,6,0,0,6,0,6,0,0,0,0,0,0,"2ND  "
"ANCHORAGE (MUNICIPALITY)",2020,204,164,0,0,40,13,9,0,0,4,191,155,0,36,AK
"BETHEL (CENSUS AREA)",2050,3,1,0,0,2,0,0,0,0,0,3,1,0,2,AK
"DENALI (BOROUGH)",2068,1,1,0,0,0,0,0,0,0,0,1,1,0,0,AK
"FAIRBANKS NORTH STAR (BOR)",2090,66,54,0,0,12,3,1,0,0,2,63,53,0,10,AK
"JUNEAU (CITY AND BOROUGH)",2110,8,7,0,0,1,2,2,0,0,0,6,5,0,1,AK
"KENAI PENINSULA (BOROUGH)",2122,33,31,0,0,2,2,2,0,0,0,31,29,0,2,AK
"KETCHIKAN GATEWAY (BOROUGH)",2130,13,10,0,0,3,1,1,0,0,0,12,9,0,3,AK
"KODIAK ISLAND (BOROUGH)",2150,2,1,0,1,0,1,0,0,1,0,1,1,0,0,AK
"MATANUSKA-SUSITNA (BOROUGH)",2170,84,73,0,0,11,6,5,0,0,1,78,68,0,10,AK
"NORTHWEST ARCTIC (BOROUGH)",2188,1,1,0,0,0,1,1,0,0,0,0,0,0,0,AK
"PRINCE OF WALES-HYDER (CENSUS)",2198,2,2,0,0,0,0,0,0,0,0,2,2,0,0,AK
"SKAGWAY (MUNICIPALITY)",2230,1,1,0,0,0,1,1,0,0,0,0,0,0,0,AK
"VALDEZ-CORDOVA (CENSUS AREA)",2261,3,3,0,0,0,0,0,0,0,0,3,3,0,0,AK
"WADE HAMPTON (CENSUS AREA)",2270,2,1,0,0,1,0,0,0,0,0,2,1,0,1,AK
"WRANGELL (CITY AND BOROUGH)",2275,1,1,0,0,0,0,0,0,0,0,1,1,0,0,AK
"YAKUTAT (CITY AND BOROUGH)",2282,1,0,0,0,1,0,0,0,0,0,1,0,0,1,AK
SEMINOLE,12117,1,0,0,0,1,1,0,0,0,1,0,0,0,0,AK
UMATILLA,41059,1,0,0,0,1,0,0,0,0,0,1,0,0,1,AK
WEBER,49057,1,0,0,0,1,0,0,0,0,0,1,0,0,1,AK
AUTAUGA,1001,314,88,1,0,225,7,6,1,0,0,307,82,0,225,"AL M"
BALDWIN,1003,2,0,0,0,2,0,0,0,0,0,2,0,0,2,"AL M"
BARBOUR,1005,211,23,0,0,188,2,2,0,0,0,209,21,0,188,"AL M"
BIBB,1007,2,0,0,0,2,0,0,0,0,0,2,0,0,2,"AL M"
BLOUNT,1009,1,0,0,0,1,0,0,0,0,0,1,0,0,1,"AL M"
BULLOCK,1011,45,2,0,0,43,0,0,0,0,0,45,2,0,43,"AL M"
BUTLER,1013,199,14,0,0,185,0,0,0,0,0,199,14,0,185,"AL M"
CALHOUN,1015,2,0,0,0,2,0,0,0,0,0,2,0,0,2,"AL M"
CHAMBERS,1017,387,64,0,0,323,3,2,0,0,1,384,62,0,322,"AL M"
CHILTON,1021,198,79,0,0,119,5,5,0,0,0,193,74,0,119,"AL M"
CLARKE,1025,4,1,0,0,3,1,1,0,0,0,3,0,0,3,"AL M"
CLAY,1027,113,23,0,0,90,2,2,0,0,0,111,21,0,90,"AL M"
COFFEE,1031,281,40,1,0,240,1,0,1,0,0,280,40,0,240,"AL M"
CONECUH,1035,40,6,0,0,34,0,0,0,0,0,40,6,0,34,"AL M"
COOSA,1037,47,13,0,0,34,0,0,0,0,0,47,13,0,34,"AL M"
COVINGTON,1039,191,35,0,0,156,2,2,0,0,0,189,33,0,156,"AL M"
CRENSHAW,1041,84,14,0,0,70,0,0,0,0,0,84,14,0,70,"AL M"
DALE,1045,364,53,1,0,310,2,0,1,0,1,362,53,0,309,"AL M"
DALLAS,1047,66,7,1,0,58,1,0,1,0,0,65,7,0,58,"AL M"
ELMORE,1051,450,97,0,0,353,3,3,0,0,0,447,94,0,353,"AL M"
ESCAMBIA,1053,51,4,0,0,47,0,0,0,0,0,51,4,0,47,"AL M"
ETOWAH,1055,1,1,0,0,0,0,0,0,0,0,1,1,0,0,"AL M"
GENEVA,1061,102,27,0,1,74,3,1,0,1,1,99,26,0,73,"AL M"
HALE,1065,1,0,0,0,1,0,0,0,0,0,1,0,0,1,"AL M"
HENRY,1067,115,14,0,0,101,3,3,0,0,0,112,11,0,101,"AL M"
HOUSTON,1069,831,181,4,1,645,18,10,4,1,3,813,171,0,642,"AL M"
JACKSON,1071,3,1,0,0,2,0,0,0,0,0,3,1,0,2,"AL M"
JEFFERSON,1073,6,6,0,0,0,0,0,0,0,0,6,6,0,0,"AL M"
LEE,1081,747,171,1,0,575,6,5,1,0,0,741,166,0,575,"AL M"
LOWNDES,1085,100,9,0,0,91,0,0,0,0,0,100,9,0,91,"AL M"
MACON,1087,184,23,0,0,161,2,1,0,0,1,182,22,0,160,"AL M"
MADISON,1089,1,0,0,0,1,0,0,0,0,0,1,0,0,1,"AL M"
MARENGO,1091,8,2,0,0,6,1,1,0,0,0,7,1,0,6,"AL M"
MOBILE,1097,5,1,0,0,4,0,0,0,0,0,5,1,0,4,"AL M"
MONROE,1099,14,2,0,0,12,0,0,0,0,0,14,2,0,12,"AL M"
MONTGOMERY,1101,1510,283,3,0,1224,25,22,2,0,1,1485,261,1,1223,"AL M"
PERRY,1105,4,0,0,0,4,0,0,0,0,0,4,0,0,4,"AL M"
PIKE,1109,201,16,0,0,185,2,0,0,0,2,199,16,0,183,"AL M"
RANDOLPH,1111,158,35,0,0,123,1,1,0,0,0,157,34,0,123,"AL M"
RUSSELL,1113,370,98,0,0,272,4,4,0,0,0,366,94,0,272,"AL M"
"ST. CLAIR",1115,1,0,0,0,1,0,0,0,0,0,1,0,0,1,"AL M"
SHELBY,1117,8,3,0,0,5,0,0,0,0,0,8,3,0,5,"AL M"
TALLADEGA,1121,6,1,0,0,5,0,0,0,0,0,6,1,0,5,"AL M"
TALLAPOOSA,1123,418,91,0,0,327,3,3,0,0,0,415,88,0,327,"AL M"
TUSCALOOSA,1125,5,2,0,0,3,0,0,0,0,0,5,2,0,3,"AL M"
WASHINGTON,1129,3,2,0,0,1,0,0,0,0,0,3,2,0,1,"AL M"
WILCOX,1131,18,1,0,0,17,0,0,0,0,0,18,1,0,17,"AL M"
BAY,12005,3,1,0,0,2,0,0,0,0,0,3,1,0,2,"AL M"
ESCAMBIA,12033,1,1,0,0,0,0,0,0,0,0,1,1,0,0,"AL M"
GADSDEN,12039,2,0,0,0,2,0,0,0,0,0,2,0,0,2,"AL M"
HOLMES,12059,12,7,0,0,5,1,1,0,0,0,11,6,0,5,"AL M"
JACKSON,12063,16,4,0,0,12,0,0,0,0,0,16,4,0,12,"AL M"
LEON,12073,2,1,0,0,1,0,0,0,0,0,2,1,0,1,"AL M"
"SANTA ROSA",12113,1,0,0,0,1,0,0,0,0,0,1,0,0,1,"AL M"
WALTON,12131,1,0,0,0,1,0,0,0,0,0,1,0,0,1,"AL M"
WASHINGTON,12133,3,2,0,0,1,0,0,0,0,0,3,2,0,1,"AL M"
CLAY,13061,2,0,0,0,2,0,0,0,0,0,2,0,0,2,"AL M"
COBB,13067,1,1,0,0,0,0,0,0,0,0,1,1,0,0,"AL M"
COLQUITT,13071,1,0,0,0,1,0,0,0,0,0,1,0,0,1,"AL M"
COWETA,13077,1,1,0,0,0,0,0,0,0,0,1,1,0,0,"AL M"
DECATUR,13087,5,0,0,0,5,0,0,0,0,0,5,0,0,5,"AL M"
DEKALB,13089,2,0,0,0,2,0,0,0,0,0,2,0,0,2,"AL M"
DOUGHERTY,13095,1,0,0,0,1,0,0,0,0,0,1,0,0,1,"AL M"
DOUGLAS,13097,1,0,0,0,1,0,0,0,0,0,1,0,0,1,"AL M"
EARLY,13099,9,3,0,0,6,1,1,0,0,0,8,2,0,6,"AL M"
EFFINGHAM,13103,1,0,0,0,1,0,0,0,0,0,1,0,0,1,"AL M"
FULTON,13121,2,1,0,0,1,0,0,0,0,0,2,1,0,1,"AL M"
GWINNETT,13135,1,1,0,0,0,0,0,0,0,0,1,1,0,0,"AL M"
HARRIS,13145,1,0,0,0,1,0,0,0,0,0,1,0,0,1,"AL M"
HOUSTON,13153,1,0,0,0,1,0,0,0,0,0,1,0,0,1,"AL M"
MILLER,13201,1,1,0,0,0,0,0,0,0,0,1,1,0,0,"AL M"
MUSCOGEE,13215,8,2,0,0,6,0,0,0,0,0,8,2,0,6,"AL M"
QUITMAN,13239,18,2,0,0,16,0,0,0,0,0,18,2,0,16,"AL M"
RANDOLPH,13243,1,0,0,0,1,0,0,0,0,0,1,0,0,1,"AL M"
RICHMOND,13245,1,0,0,0,1,0,0,0,0,0,1,0,0,1,"AL M"
SEMINOLE,13253,3,1,0,0,2,0,0,0,0,0,3,1,0,2,"AL M"
TROUP,13285,8,1,0,0,7,0,0,0,0,0,8,1,0,7,"AL M"
ALLEN,18003,1,0,0,0,1,0,0,0,0,0,1,0,0,1,"AL M"
ORLEANS,22071,1,0,0,0,1,0,0,0,0,0,1,0,0,1,"AL M"
DAVIDSON,47037,1,1,0,0,0,1,1,0,0,0,0,0,0,0,"AL M"
"VIRGINIA BEACH (CITY)",51810,1,0,0,0,1,0,0,0,0,0,1,0,0,1,"AL M"
"OUTSIDE HOME STATE",88888,20,7,0,0,13,0,0,0,0,0,20,7,0,13,"AL M"
"OUTSIDE U.S.",99999,1,0,0,0,1,0,0,0,0,0,1,0,0,1,"AL M"
AUTAUGA,1001,1,1,0,0,0,1,1,0,0,0,0,0,0,0,"AL N"
BIBB,1007,106,36,1,0,69,2,1,1,0,0,104,35,0,69,"AL N"
BLOUNT,1009,180,114,0,0,66,7,7,0,0,0,173,107,0,66,"AL N"
CALHOUN,1015,413,283,2,0,128,7,5,2,0,0,406,278,0,128,"AL N"
CHEROKEE,1019,92,65,0,0,27,2,2,0,0,0,90,63,0,27,"AL N"
CHILTON,1021,17,12,0,0,5,0,0,0,0,0,17,12,0,5,"AL N"
CHOCTAW,1023,1,0,0,0,1,0,0,0,0,0,1,0,0,1,"AL N"
CLAY,1027,34,20,0,0,14,1,0,0,0,1,33,20,0,13,"AL N"
CLEBURNE,1029,38,27,0,0,11,4,4,0,0,0,34,23,0,11,"AL N"
COLBERT,1033,239,118,2,0,119,2,1,1,0,0,237,117,1,119,"AL N"
CULLMAN,1043,396,250,0,1,145,2,1,0,1,0,394,249,0,145,"AL N"
DALE,1045,1,1,0,0,0,0,0,0,0,0,1,1,0,0,"AL N"
DEKALB,1049,150,110,0,0,40,6,5,0,0,1,144,105,0,39,"AL N"
ELMORE,1051,1,1,0,0,0,0,0,0,0,0,1,1,0,0,"AL N"
ETOWAH,1055,353,247,0,0,106,3,3,0,0,0,350,244,0,106,"AL N"
FAYETTE,1057,56,12,0,0,44,0,0,0,0,0,56,12,0,44,"AL N"
FRANKLIN,1059,98,57,0,0,41,1,1,0,0,0,97,56,0,41,"AL N"
GREENE,1063,63,6,0,0,57,0,0,0,0,0,63,6,0,57,"AL N"
HALE,1065,73,8,0,0,65,0,0,0,0,0,73,8,0,65,"AL N"
JACKSON,1071,162,88,0,0,74,0,0,0,0,0,162,88,0,74,"AL N"
JEFFERSON,1073,3831,1902,6,0,1923,47,40,6,0,1,3784,1862,0,1922,"AL N"
LAMAR,1075,35,10,0,0,25,1,1,0,0,0,34,9,0,25,"AL N"
LAUDERDALE,1077,559,270,0,0,289,8,7,0,0,1,551,263,0,288,"AL N"
LAWRENCE,1079,98,48,0,0,50,0,0,0,0,0,98,48,0,50,"AL N"
LIMESTONE,1083,450,235,0,0,215,5,5,0,0,0,445,230,0,215,"AL N"
MADISON,1089,1509,738,11,0,760,33,22,11,0,0,1476,716,0,760,"AL N"
MARENGO,1091,16,4,0,0,12,1,1,0,0,0,15,3,0,12,"AL N"
MARION,1093,70,35,0,0,35,0,0,0,0,0,70,35,0,35,"AL N"
MARSHALL,1095,299,233,0,0,66,3,2,0,0,1,296,231,0,65,"AL N"
MOBILE,1097,2,2,0,0,0,0,0,0,0,0,2,2,0,0,"AL N"
MONTGOMERY,1101,2,1,0,0,1,0,0,0,0,0,2,1,0,1,"AL N"
MORGAN,1103,460,252,2,0,206,7,5,2,0,0,453,247,0,206,"AL N"
PERRY,1105,7,0,0,0,7,0,0,0,0,0,7,0,0,7,"AL N"
PICKENS,1107,104,12,0,0,92,0,0,0,0,0,104,12,0,92,"AL N"
PIKE,1109,1,1,0,0,0,0,0,0,0,0,1,1,0,0,"AL N"
RANDOLPH,1111,3,1,0,0,2,0,0,0,0,0,3,1,0,2,"AL N"
RUSSELL,1113,1,0,1,0,0,1,0,1,0,0,0,0,0,0,"AL N"
"ST. CLAIR",1115,267,192,2,0,73,5,3,2,0,0,262,189,0,73,"AL N"
SHELBY,1117,686,445,3,0,238,30,28,2,0,0,656,417,1,238,"AL N"
SUMTER,1119,42,7,0,0,35,2,2,0,0,0,40,5,0,35,"AL N"
TALLADEGA,1121,346,169,0,0,177,2,2,0,0,0,344,167,0,177,"AL N"
TALLAPOOSA,1123,2,2,0,0,0,0,0,0,0,0,2,2,0,0,"AL N"
TUSCALOOSA,1125,1284,208,4,0,1072,12,7,4,0,1,1272,201,0,1071,"AL N"
WALKER,1127,276,128,0,0,148,1,1,0,0,0,275,127,0,148,"AL N"
WINSTON,1133,44,22,0,0,22,1,1,0,0,0,43,21,0,22,"AL N"
CRAWFORD,5033,1,0,0,0,1,0,0,0,0,0,1,0,0,1,"AL N"
PRAIRIE,5117,1,1,0,0,0,0,0,0,0,0,1,1,0,0,"AL N"
BARTOW,13015,1,0,0,0,1,0,0,0,0,0,1,0,0,1,"AL N"
CARROLL,13045,1,1,0,0,0,0,0,0,0,0,1,1,0,0,"AL N"
CHEROKEE,13057,1,1,0,0,0,0,0,0,0,0,1,1,0,0,"AL N"
CLAYTON,13063,1,0,0,0,1,0,0,0,0,0,1,0,0,1,"AL N"
COBB,13067,1,1,0,0,0,0,0,0,0,0,1,1,0,0,"AL N"
DEKALB,13089,1,1,0,0,0,0,0,0,0,0,1,1,0,0,"AL N"
FULTON,13121,1,1,0,0,0,0,0,0,0,0,1,1,0,0,"AL N"
GWINNETT,13135,1,0,0,0,1,0,0,0,0,0,1,0,0,1,"AL N"
PAULDING,13223,1,0,0,0,1,0,0,0,0,0,1,0,0,1,"AL N"
POLK,13233,2,2,0,0,0,0,0,0,0,0,2,2,0,0,"AL N"
ROCKDALE,13247,1,1,0,0,0,0,0,0,0,0,1,1,0,0,"AL N"
WALKER,13295,2,0,0,0,2,0,0,0,0,0,2,0,0,2,"AL N"
"ST. CLAIR",17163,1,0,0,0,1,0,0,0,0,0,1,0,0,1,"AL N"
MARION,18097,1,1,0,0,0,1,1,0,0,0,0,0,0,0,"AL N"
HARDIN,21093,1,0,0,0,1,0,0,0,0,0,1,0,0,1,"AL N"
BOSSIER,22015,2,1,0,0,1,0,0,0,0,0,2,1,0,1,"AL N"
LIVINGSTON,22063,1,1,0,0,0,0,0,0,0,0,1,1,0,0,"AL N"
"ANNE ARUNDEL",24003,1,1,0,0,0,0,0,0,0,0,1,1,0,0,"AL N"
"PRINCE GEORGE'S",24033,1,0,0,0,1,0,0,0,0,0,1,0,0,1,"AL N"
TISHOMINGO,28141,4,4,0,0,0,0,0,0,0,0,4,4,0,0,"AL N"
FRANKLIN,47051,1,1,0,0,0,0,0,0,0,0,1,1,0,0,"AL N"
GILES,47055,2,2,0,0,0,0,0,0,0,0,2,2,0,0,"AL N"
LINCOLN,47103,9,6,0,0,3,1,1,0,0,0,8,5,0,3,"AL N"
MAURY,47119,3,0,0,0,3,0,0,0,0,0,3,0,0,3,"AL N"
SEVIER,47155,1,1,0,0,0,0,0,0,0,0,1,1,0,0,"AL N"
WAYNE,47181,3,2,0,0,1,0,0,0,0,0,3,2,0,1,"AL N"
BURNET,48053,1,1,0,0,0,0,0,0,0,0,1,1,0,0,"AL N"
WEBER,49057,1,0,0,0,1,0,0,0,0,0,1,0,0,1,"AL N"
"LYNCHBURG (CITY)",51680,1,0,0,0,1,0,0,0,0,0,1,0,0,1,"AL N"
"OUTSIDE HOME STATE",88888,15,2,0,0,13,0,0,0,0,0,15,2,0,13,"AL N"
BALDWIN,1003,815,352,8,0,455,21,13,7,0,1,794,339,1,454,"AL S"
BUTLER,1013,1,1,0,0,0,0,0,0,0,0,1,1,0,0,"AL S"
CHOCTAW,1023,34,7,1,0,26,0,0,0,0,0,34,7,1,26,"AL S"
CLARKE,1025,102,23,1,0,78,2,1,1,0,0,100,22,0,78,"AL S"
CONECUH,1035,31,7,0,0,24,1,0,0,0,1,30,7,0,23,"AL S"
DALLAS,1047,332,85,4,0,243,8,3,3,0,2,324,82,1,241,"AL S"
ELMORE,1051,1,0,0,0,1,0,0,0,0,0,1,0,0,1,"AL S"
ESCAMBIA,1053,143,32,0,0,111,2,2,0,0,0,141,30,0,111,"AL S"
GREENE,1063,2,0,0,0,2,0,0,0,0,0,2,0,0,2,"AL S"
HALE,1065,14,3,0,0,11,0,0,0,0,0,14,3,0,11,"AL S"
JEFFERSON,1073,1,1,0,0,0,0,0,0,0,0,1,1,0,0,"AL S"
MADISON,1089,1,0,0,0,1,0,0,0,0,0,1,0,0,1,"AL S"
MARENGO,1091,88,22,0,0,66,1,0,0,0,1,87,22,0,65,"AL S"
MOBILE,1097,2483,714,7,1,1761,21,16,4,1,0,2462,698,3,1761,"AL S"
MONROE,1099,83,10,1,0,72,2,1,1,0,0,81,9,0,72,"AL S"
MONTGOMERY,1101,2,0,0,0,2,0,0,0,0,0,2,0,0,2,"AL S"
PERRY,1105,13,0,0,0,13,0,0,0,0,0,13,0,0,13,"AL S"
SUMTER,1119,5,1,0,0,4,0,0,0,0,0,5,1,0,4,"AL S"
TUSCALOOSA,1125,1,0,0,0,1,0,0,0,0,0,1,0,0,1,"AL S"
WASHINGTON,1129,71,9,0,0,62,0,0,0,0,0,71,9,0,62,"AL S"
WILCOX,1131,60,20,1,0,39,0,0,0,0,0,60,20,1,39,"AL S"
DEKALB,13089,2,1,0,0,1,0,0,0,0,0,2,1,0,1,"AL S"
CALCASIEU,22019,1,0,0,0,1,0,0,0,0,0,1,0,0,1,"AL S"
MACOMB,26099,1,0,0,0,1,0,0,0,0,0,1,0,0,1,"AL S"
WAYNE,26163,1,1,0,0,0,0,0,0,0,0,1,1,0,0,"AL S"
MARION,28091,1,1,0,0,0,0,0,0,0,0,1,1,0,0,"AL S"
MONTGOMERY,39113,1,0,0,0,1,0,0,0,0,0,1,0,0,1,"AL S"
OKLAHOMA,40109,2,2,0,0,0,2,2,0,0,0,0,0,0,0,"AL S"
WAUKESHA,55133,1,0,0,0,1,0,0,0,0,0,1,0,0,1,"AL S"
"OUTSIDE HOME STATE",88888,4,0,1,0,3,1,0,1,0,0,3,0,0,3,"AL S"
TUSCALOOSA,1125,1,0,0,0,1,0,0,0,0,0,1,0,0,1,"AR E"
ARKANSAS,5001,139,39,0,1,99,2,1,0,1,0,137,38,0,99,"AR E"
ASHLEY,5003,2,1,0,0,1,0,0,0,0,0,2,1,0,1,"AR E"
BRADLEY,5011,2,0,0,0,2,0,0,0,0,0,2,0,0,2,"AR E"
CHICOT,5017,35,14,0,0,21,0,0,0,0,0,35,14,0,21,"AR E"
CLAY,5021,13,11,0,0,2,0,0,0,0,0,13,11,0,2,"AR E"
CLEBURNE,5023,50,39,0,0,11,0,0,0,0,0,50,39,0,11,"AR E"
CLEVELAND,5025,46,18,0,0,28,2,2,0,0,0,44,16,0,28,"AR E"
CONWAY,5029,40,26,0,0,14,0,0,0,0,0,40,26,0,14,"AR E"
CRAIGHEAD,5031,196,153,1,0,42,8,7,1,0,0,188,146,0,42,"AR E"
CRAWFORD,5033,1,0,0,0,1,0,0,0,0,0,1,0,0,1,"AR E"
CRITTENDEN,5035,120,54,0,0,66,1,0,0,0,1,119,54,0,65,"AR E"
CROSS,5037,26,24,0,0,2,1,1,0,0,0,25,23,0,2,"AR E"
DALLAS,5039,43,12,0,0,31,0,0,0,0,0,43,12,0,31,"AR E"
DESHA,5041,63,18,0,1,44,3,2,0,1,0,60,16,0,44,"AR E"
DREW,5043,73,21,1,0,51,2,1,1,0,0,71,20,0,51,"AR E"
FAULKNER,5045,272,132,1,0,139,3,2,1,0,0,269,130,0,139,"AR E"
FULTON,5049,12,12,0,0,0,0,0,0,0,0,12,12,0,0,"AR E"
GARLAND,5051,1,0,0,0,1,0,0,0,0,0,1,0,0,1,"AR E"
GRANT,5053,362,125,0,0,237,5,4,0,0,1,357,121,0,236,"AR E"
GREENE,5055,70,57,0,0,13,1,1,0,0,0,69,56,0,13,"AR E"
"HOT SPRING",5059,1,0,0,0,1,0,0,0,0,0,1,0,0,1,"AR E"
INDEPENDENCE,5063,48,39,0,0,9,2,0,0,0,2,46,39,0,7,"AR E"
IZARD,5065,7,4,0,1,2,2,1,0,1,0,5,3,0,2,"AR E"
JACKSON,5067,25,22,0,0,3,1,1,0,0,0,24,21,0,3,"AR E"
JEFFERSON,5069,2020,653,11,1,1355,25,9,9,1,6,1995,644,2,1349,"AR E"
JOHNSON,5071,1,1,0,0,0,0,0,0,0,0,1,1,0,0,"AR E"
LAWRENCE,5075,16,15,0,0,1,1,1,0,0,0,15,14,0,1,"AR E"
LEE,5077,14,4,0,0,10,0,0,0,0,0,14,4,0,10,"AR E"
LINCOLN,5079,63,18,0,1,44,3,0,0,1,2,60,18,0,42,"AR E"
LOGAN,5083,1,0,0,0,1,0,0,0,0,0,1,0,0,1,"AR E"
LONOKE,5085,228,105,0,0,123,8,7,0,0,1,220,98,0,122,"AR E"
MISSISSIPPI,5093,86,61,0,0,25,1,0,0,0,1,85,61,0,24,"AR E"
MONROE,5095,13,6,0,0,7,1,1,0,0,0,12,5,0,7,"AR E"
OUACHITA,5103,1,1,0,0,0,0,0,0,0,0,1,1,0,0,"AR E"
PERRY,5105,18,13,0,0,5,0,0,0,0,0,18,13,0,5,"AR E"
PHILLIPS,5107,40,31,0,1,8,1,0,0,1,0,39,31,0,8,"AR E"
POINSETT,5111,50,44,0,0,6,0,0,0,0,0,50,44,0,6,"AR E"
POLK,5113,2,0,0,0,2,0,0,0,0,0,2,0,0,2,"AR E"
POPE,5115,101,79,0,0,22,2,2,0,0,0,99,77,0,22,"AR E"
PRAIRIE,5117,16,3,0,0,13,0,0,0,0,0,16,3,0,13,"AR E"
PULASKI,5119,1717,663,0,0,1054,23,18,0,0,5,1694,645,0,1049,"AR E"
RANDOLPH,5121,24,20,0,0,4,0,0,0,0,0,24,20,0,4,"AR E"
"ST. FRANCIS",5123,33,20,0,0,13,0,0,0,0,0,33,20,0,13,"AR E"
SALINE,5125,434,191,2,0,241,12,8,2,0,2,422,183,0,239,"AR E"
SEBASTIAN,5131,1,1,0,0,0,0,0,0,0,0,1,1,0,0,"AR E"
SHARP,5135,27,23,1,0,3,1,0,1,0,0,26,23,0,3,"AR E"
STONE,5137,13,10,0,1,2,1,0,0,1,0,12,10,0,2,"AR E"
UNION,5139,2,0,0,0,2,0,0,0,0,0,2,0,0,2,"AR E"
"VAN BUREN",5141,33,20,0,0,13,0,0,0,0,0,33,20,0,13,"AR E"
WASHINGTON,5143,2,2,0,0,0,0,0,0,0,0,2,2,0,0,"AR E"
WHITE,5145,223,116,0,0,107,10,7,0,0,3,213,109,0,104,"AR E"
WOODRUFF,5147,10,8,0,0,2,0,0,0,0,0,10,8,0,2,"AR E"
YELL,5149,26,17,0,0,9,0,0,0,0,0,26,17,0,9,"AR E"
LAKE,18089,1,0,0,0,1,0,0,0,0,0,1,0,0,1,"AR E"
DAVIDSON,47037,1,1,0,0,0,0,0,0,0,0,1,1,0,0,"AR E"
SHELBY,47157,3,0,0,0,3,0,0,0,0,0,3,0,0,3,"AR E"
DALLAS,48113,1,0,0,0,1,0,0,0,0,0,1,0,0,1,"AR E"
"OUTSIDE HOME STATE",88888,1,1,0,0,0,0,0,0,0,0,1,1,0,0,"AR E"
ARKANSAS,5001,1,1,0,0,0,0,0,0,0,0,1,1,0,0,"AR W"
ASHLEY,5003,78,31,0,0,47,3,3,0,0,0,75,28,0,47,"AR W"
BAXTER,5005,72,70,0,0,2,1,1,0,0,0,71,69,0,2,"AR W"
BENTON,5007,625,368,3,0,254,30,23,3,0,4,595,345,0,250,"AR W"
BOONE,5009,57,51,0,0,6,0,0,0,0,0,57,51,0,6,"AR W"
BRADLEY,5011,39,6,0,0,33,3,3,0,0,0,36,3,0,33,"AR W"
CALHOUN,5013,23,10,0,0,13,0,0,0,0,0,23,10,0,13,"AR W"
CARROLL,5015,37,26,1,0,10,1,1,0,0,0,36,25,1,10,"AR W"
CLARK,5019,106,53,0,0,53,2,2,0,0,0,104,51,0,53,"AR W"
COLUMBIA,5027,93,25,0,2,66,2,0,0,2,0,91,25,0,66,"AR W"
CRAWFORD,5033,160,110,2,0,48,2,0,2,0,0,158,110,0,48,"AR W"
DREW,5043,1,0,0,0,1,0,0,0,0,0,1,0,0,1,"AR W"
FAULKNER,5045,2,0,0,0,2,0,0,0,0,0,2,0,0,2,"AR W"
FRANKLIN,5047,36,22,0,1,13,1,0,0,1,0,35,22,0,13,"AR W"
GARLAND,5051,526,286,2,2,236,9,3,2,2,2,517,283,0,234,"AR W"
HEMPSTEAD,5057,61,26,0,0,35,4,3,0,0,1,57,23,0,34,"AR W"
"HOT SPRING",5059,181,96,0,1,84,1,0,0,1,0,180,96,0,84,"AR W"
HOWARD,5061,31,13,1,0,17,3,0,1,0,2,28,13,0,15,"AR W"
JEFFERSON,5069,1,0,0,0,1,0,0,0,0,0,1,0,0,1,"AR W"
JOHNSON,5071,60,46,0,0,14,0,0,0,0,0,60,46,0,14,"AR W"
LAFAYETTE,5073,40,16,0,0,24,0,0,0,0,0,40,16,0,24,"AR W"
"LITTLE RIVER",5081,32,16,0,0,16,1,1,0,0,0,31,15,0,16,"AR W"
LOGAN,5083,28,21,0,1,6,1,0,0,1,0,27,21,0,6,"AR W"
LONOKE,5085,1,1,0,0,0,0,0,0,0,0,1,1,0,0,"AR W"
MADISON,5087,44,28,0,0,16,1,1,0,0,0,43,27,0,16,"AR W"
MARION,5089,27,26,0,0,1,2,2,0,0,0,25,24,0,1,"AR W"
MILLER,5091,114,53,0,0,61,5,4,0,0,1,109,49,0,60,"AR W"
MONTGOMERY,5097,13,10,0,0,3,0,0,0,0,0,13,10,0,3,"AR W"
NEVADA,5099,21,9,0,0,12,0,0,0,0,0,21,9,0,12,"AR W"
NEWTON,5101,12,11,0,0,1,0,0,0,0,0,12,11,0,1,"AR W"
OUACHITA,5103,103,37,0,0,66,0,0,0,0,0,103,37,0,66,"AR W"
PERRY,5105,1,1,0,0,0,0,0,0,0,0,1,1,0,0,"AR W"
PIKE,5109,17,14,0,0,3,0,0,0,0,0,17,14,0,3,"AR W"
POLK,5113,30,21,0,0,9,0,0,0,0,0,30,21,0,9,"AR W"
POPE,5115,1,0,0,0,0,1,0,0,0,0,0,0,0,0,"AR W"
PULASKI,5119,4,0,0,0,4,0,0,0,0,0,4,0,0,4,"AR W"
SALINE,5125,1,1,0,0,0,0,0,0,0,0,1,1,0,0,"AR W"
SCOTT,5127,55,35,0,0,20,1,1,0,0,0,54,34,0,20,"AR W"
SEARCY,5129,12,9,0,0,3,0,0,0,0,0,12,9,0,3,"AR W"
SEBASTIAN,5131,306,189,2,0,115,5,2,2,0,1,301,187,0,114,"AR W"
SEVIER,5133,19,12,0,0,7,0,0,0,0,0,19,12,0,7,"AR W"
STONE,5137,1,1,0,0,0,0,0,0,0,0,1,1,0,0,"AR W"
UNION,5139,160,37,0,0,123,0,0,0,0,0,160,37,0,123,"AR W"
"VAN BUREN",5141,1,1,0,0,0,0,0,0,0,0,1,1,0,0,"AR W"
WASHINGTON,5143,581,345,12,2,222,37,22,11,2,2,544,323,1,220,"AR W"
"ST. CLAIR",17163,1,0,0,0,1,0,0,0,0,0,1,0,0,1,"AR W"
PERRY,21193,1,0,0,0,1,0,0,0,0,0,1,0,0,1,"AR W"
MOREHOUSE,22067,1,0,0,0,1,0,0,0,0,0,1,0,0,1,"AR W"
BOWIE,48037,1,0,0,0,1,0,0,0,0,0,1,0,0,1,"AR W"
COMAL,48091,1,0,0,0,1,1,0,0,0,1,0,0,0,0,"AR W"
DENTON,48121,1,0,0,0,1,0,0,0,0,0,1,0,0,1,"AR W"
JEFFERSON,48245,1,0,0,0,1,0,0,0,0,0,1,0,0,1,"AR W"
ISLAND,53029,1,1,0,0,0,0,0,0,0,0,1,1,0,0,"AR W"
APACHE,4001,30,20,0,0,10,0,0,0,0,0,30,20,0,10,AZ
COCHISE,4003,452,388,8,3,53,20,9,7,3,1,432,379,1,52,AZ
COCONINO,4005,162,134,2,0,26,5,4,1,0,0,157,130,1,26,AZ
GILA,4007,93,81,3,0,9,5,3,2,0,0,88,78,1,9,AZ
GRAHAM,4009,53,49,1,0,3,2,1,1,0,0,51,48,0,3,AZ
GREENLEE,4011,10,10,0,0,0,0,0,0,0,0,10,10,0,0,AZ
"LA PAZ",4012,20,19,0,0,1,1,1,0,0,0,19,18,0,1,AZ
MARICOPA,4013,12251,10596,158,0,1497,458,324,120,0,14,11793,10272,38,1483,AZ
MOHAVE,4015,474,441,1,0,32,2,2,0,0,0,472,439,1,32,AZ
NAVAJO,4017,120,95,1,0,24,4,3,1,0,0,116,92,0,24,AZ
PIMA,4019,2464,1961,45,0,458,71,39,27,0,5,2393,1922,18,453,AZ
PINAL,4021,1993,1746,12,3,232,28,17,6,3,2,1965,1729,6,230,AZ
"SANTA CRUZ",4023,102,86,1,0,15,3,3,0,0,0,99,83,1,15,AZ
YAVAPAI,4025,487,446,10,0,31,19,12,7,0,0,468,434,3,31,AZ
YUMA,4027,331,292,7,0,32,10,6,4,0,0,321,286,3,32,AZ
KENT,26081,1,0,0,0,1,0,0,0,0,0,1,0,0,1,AZ
OLMSTED,27109,1,0,0,0,1,0,0,0,0,0,1,0,0,1,AZ
MULTNOMAH,41051,1,1,0,0,0,0,0,0,0,0,1,1,0,0,AZ
"OUTSIDE U.S.",99999,1,1,0,0,0,0,0,0,0,0,1,1,0,0,AZ
MOBILE,1097,1,1,0,0,0,1,1,0,0,0,0,0,0,0,"CA C"
NEVADA,5099,1,1,0,0,0,1,1,0,0,0,0,0,0,0,"CA C"
ALAMEDA,6001,4,3,0,0,1,0,0,0,0,0,4,3,0,1,"CA C"
"CONTRA COSTA",6013,1,0,1,0,0,0,0,0,0,0,1,0,1,0,"CA C"
IMPERIAL,6025,1,1,0,0,0,0,0,0,0,0,1,1,0,0,"CA C"
KERN,6029,6,5,0,0,1,0,0,0,0,0,6,5,0,1,"CA C"
KINGS,6031,2,0,2,0,0,2,0,2,0,0,0,0,0,0,"CA C"
LAKE,6033,2,2,0,0,0,0,0,0,0,0,2,2,0,0,"CA C"
LASSEN,6035,1,1,0,0,0,0,0,0,0,0,1,1,0,0,"CA C"
"LOS ANGELES",6037,26590,20338,285,0,5967,1015,802,170,0,43,25575,19536,115,5924,"CA C"
MADERA,6039,8,6,0,0,2,1,1,0,0,0,7,5,0,2,"CA C"
MARIN,6041,2,0,0,0,2,0,0,0,0,0,2,0,0,2,"CA C"
MERCED,6047,2,2,0,0,0,0,0,0,0,0,2,2,0,0,"CA C"
MONTEREY,6053,1,0,0,0,1,0,0,0,0,0,1,0,0,1,"CA C"
ORANGE,6059,6730,5460,77,0,1193,357,284,57,0,16,6373,5176,20,1177,"CA C"
PLUMAS,6063,1,1,0,0,0,0,0,0,0,0,1,1,0,0,"CA C"
RIVERSIDE,6065,7390,6052,17,0,1321,157,133,12,0,12,7233,5919,5,1309,"CA C"
SACRAMENTO,6067,8,5,0,0,3,0,0,0,0,0,8,5,0,3,"CA C"
"SAN BENITO",6069,2,1,0,0,1,0,0,0,0,0,2,1,0,1,"CA C"
"SAN BERNARDINO",6071,6486,5400,18,0,1068,124,107,13,0,4,6362,5293,5,1064,"CA C"
"SAN DIEGO",6073,29,21,2,0,6,3,2,1,0,0,26,19,1,6,"CA C"
"SAN FRANCISCO",6075,1,1,0,0,0,0,0,0,0,0,1,1,0,0,"CA C"
"SAN JOAQUIN",6077,1,1,0,0,0,0,0,0,0,0,1,1,0,0,"CA C"
"SAN LUIS OBISPO",6079,1068,894,10,0,164,65,54,7,0,4,1003,840,3,160,"CA C"
"SAN MATEO",6081,1,0,0,0,1,0,0,0,0,0,1,0,0,1,"CA C"
"SANTA BARBARA",6083,1317,1065,14,1,237,55,42,9,1,3,1262,1023,5,234,"CA C"
"SANTA CLARA",6085,6,1,0,0,5,0,0,0,0,0,6,1,0,5,"CA C"
"SANTA CRUZ",6087,1,1,0,0,0,0,0,0,0,0,1,1,0,0,"CA C"
SHASTA,6089,1,1,0,0,0,0,0,0,0,0,1,1,0,0,"CA C"
SOLANO,6095,1,0,0,0,1,0,0,0,0,0,1,0,0,1,"CA C"
TULARE,6107,2,1,0,0,1,0,0,0,0,0,2,1,0,1,"CA C"
VENTURA,6111,4446,3526,35,0,885,153,123,21,0,9,4293,3403,14,876,"CA C"
DENVER,8031,1,0,0,0,1,0,0,0,0,0,1,0,0,1,"CA C"
"NEW HAVEN",9009,2,0,0,0,2,0,0,0,0,0,2,0,0,2,"CA C"
"NEW CASTLE",10003,1,0,0,0,1,0,0,0,0,0,1,0,0,1,"CA C"
HILLSBOROUGH,12057,1,0,0,0,1,0,0,0,0,0,1,0,0,1,"CA C"
POLK,12105,1,1,0,0,0,0,0,0,0,0,1,1,0,0,"CA C"
FULTON,13121,3,1,0,0,2,0,0,0,0,0,3,1,0,2,"CA C"
HONOLULU,15003,2,1,0,0,1,0,0,0,0,0,2,1,0,1,"CA C"
MAUI,15009,1,0,0,0,1,0,0,0,0,0,1,0,0,1,"CA C"
POLK,19153,1,1,0,0,0,0,0,0,0,0,1,1,0,0,"CA C"
"DE SOTO",22031,1,0,0,0,1,0,0,0,0,0,1,0,0,1,"CA C"
UNION,22111,1,0,0,0,1,0,0,0,0,0,1,0,0,1,"CA C"
SUFFOLK,25025,1,0,0,0,1,0,0,0,0,0,1,0,0,1,"CA C"
WORCESTER,25027,1,1,0,0,0,1,1,0,0,0,0,0,0,0,"CA C"
"ST. CHARLES",29183,1,1,0,0,0,0,0,0,0,0,1,1,0,0,"CA C"
"ST. LOUIS",29189,1,0,0,0,1,0,0,0,0,0,1,0,0,1,"CA C"
CLARK,32003,1,1,0,0,0,0,0,0,0,0,1,1,0,0,"CA C"
MORRIS,34027,2,0,2,0,0,2,0,2,0,0,0,0,0,0,"CA C"
BERNALILLO,35001,1,1,0,0,0,0,0,0,0,0,1,1,0,0,"CA C"
ALBANY,36001,1,0,0,0,1,0,0,0,0,0,1,0,0,1,"CA C"
"NEW YORK",36061,1,0,1,0,0,1,0,1,0,0,0,0,0,0,"CA C"
QUEENS,36081,1,1,0,0,0,1,1,0,0,0,0,0,0,0,"CA C"
MECKLENBURG,37119,1,1,0,0,0,0,0,0,0,0,1,1,0,0,"CA C"
CUYAHOGA,39035,1,0,0,0,1,0,0,0,0,0,1,0,0,1,"CA C"
FRANKLIN,39049,1,0,0,0,1,0,0,0,0,0,1,0,0,1,"CA C"
CLACKAMAS,41005,1,0,0,0,1,0,0,0,0,0,1,0,0,1,"CA C"
WASHINGTON,41067,1,0,0,0,1,0,0,0,0,0,1,0,0,1,"CA C"
FRANKLIN,42055,1,1,0,0,0,0,0,0,0,0,1,1,0,0,"CA C"
BELL,48027,1,1,0,0,0,0,0,0,0,0,1,1,0,0,"CA C"
COLLIN,48085,1,1,0,0,0,0,0,0,0,0,1,1,0,0,"CA C"
HARRIS,48201,1,0,1,0,0,1,0,1,0,0,0,0,0,0,"CA C"
PARKER,48367,1,0,0,0,1,0,0,0,0,0,1,0,0,1,"CA C"
WASHINGTON,49053,1,1,0,0,0,0,0,0,0,0,1,1,0,0,"CA C"
ORANGE,51137,1,1,0,0,0,0,0,0,0,0,1,1,0,0,"CA C"
"NEWPORT NEWS (CITY)",51700,1,1,0,0,0,0,0,0,0,0,1,1,0,0,"CA C"
KING,53033,1,0,0,0,1,0,0,0,0,0,1,0,0,1,"CA C"
PIERCE,53053,1,0,0,0,1,0,0,0,0,0,1,0,0,1,"CA C"
"OUTSIDE HOME STATE",88888,1,1,0,0,0,0,0,0,0,0,1,1,0,0,"CA C"
"OUTSIDE U.S.",99999,7,7,0,0,0,1,1,0,0,0,6,6,0,0,"CA C"
ALAMEDA,6001,9,4,0,0,5,0,0,0,0,0,9,4,0,5,"CA E"
AMADOR,6005,87,73,0,0,14,2,1,0,0,1,85,72,0,13,"CA E"
BUTTE,6007,482,426,0,0,56,9,9,0,0,0,473,417,0,56,"CA E"
CALAVERAS,6009,92,71,0,0,21,3,1,0,0,2,89,70,0,19,"CA E"
COLUSA,6011,61,48,0,0,13,0,0,0,0,0,61,48,0,13,"CA E"
"CONTRA COSTA",6013,3,1,0,0,2,0,0,0,0,0,3,1,0,2,"CA E"
"EL DORADO",6017,371,285,3,0,83,21,15,2,0,4,350,270,1,79,"CA E"
FRESNO,6019,1814,1546,13,0,255,75,57,11,0,7,1739,1489,2,248,"CA E"
GLENN,6021,48,44,0,0,4,0,0,0,0,0,48,44,0,4,"CA E"
HUMBOLDT,6023,2,1,0,0,1,0,0,0,0,0,2,1,0,1,"CA E"
INYO,6027,20,18,0,0,2,2,1,0,0,1,18,17,0,1,"CA E"
KERN,6029,1704,1486,5,1,212,43,27,4,1,11,1661,1459,1,201,"CA E"
KINGS,6031,315,267,0,2,46,6,4,0,2,0,309,263,0,46,"CA E"
LAKE,6033,1,1,0,0,0,0,0,0,0,0,1,1,0,0,"CA E"
LASSEN,6035,45,37,0,0,8,2,2,0,0,0,43,35,0,8,"CA E"
"LOS ANGELES",6037,5,3,0,0,2,0,0,0,0,0,5,3,0,2,"CA E"
MADERA,6039,249,212,0,1,36,14,11,0,1,2,235,201,0,34,"CA E"
MARIN,6041,1,1,0,0,0,0,0,0,0,0,1,1,0,0,"CA E"
MARIPOSA,6043,16,14,0,0,2,0,0,0,0,0,16,14,0,2,"CA E"
MERCED,6047,373,314,1,0,58,14,10,1,0,3,359,304,0,55,"CA E"
MODOC,6049,8,8,0,0,0,0,0,0,0,0,8,8,0,0,"CA E"
MONO,6051,9,7,0,0,2,1,0,0,0,1,8,7,0,1,"CA E"
NAPA,6055,1,0,0,0,1,0,0,0,0,0,1,0,0,1,"CA E"
NEVADA,6057,209,169,1,0,39,4,4,0,0,0,205,165,1,39,"CA E"
ORANGE,6059,1,0,0,0,1,0,0,0,0,0,1,0,0,1,"CA E"
PLACER,6061,891,693,9,0,189,35,26,4,0,5,856,667,5,184,"CA E"
PLUMAS,6063,23,21,0,0,2,0,0,0,0,0,23,21,0,2,"CA E"
RIVERSIDE,6065,1,0,0,0,1,0,0,0,0,0,1,0,0,1,"CA E"
SACRAMENTO,6067,4211,3291,27,3,890,111,72,20,3,16,4100,3219,7,874,"CA E"
"SAN FRANCISCO",6075,2,1,0,0,1,0,0,0,0,0,2,1,0,1,"CA E"
"SAN JOAQUIN",6077,1744,1371,4,3,366,39,26,3,3,7,1705,1345,1,359,"CA E"
"SAN MATEO",6081,3,1,0,0,2,0,0,0,0,0,3,1,0,2,"CA E"
"SANTA CLARA",6085,5,3,0,0,2,0,0,0,0,0,5,3,0,2,"CA E"
"SANTA CRUZ",6087,1,0,0,0,1,0,0,0,0,0,1,0,0,1,"CA E"
SHASTA,6089,439,388,3,0,48,13,7,3,0,3,426,381,0,45,"CA E"
SIERRA,6091,4,2,0,0,2,1,0,0,0,1,3,2,0,1,"CA E"
SISKIYOU,6093,83,77,0,0,6,1,0,0,0,1,82,77,0,5,"CA E"
SOLANO,6095,1177,858,4,1,314,26,20,1,1,4,1151,838,3,310,"CA E"
SONOMA,6097,1,1,0,0,0,0,0,0,0,0,1,1,0,0,"CA E"
STANISLAUS,6099,3659,2902,16,0,741,97,68,13,0,16,3562,2834,3,725,"CA E"
SUTTER,6101,193,156,1,1,35,5,3,1,1,0,188,153,0,35,"CA E"
TEHAMA,6103,126,110,0,1,15,2,1,0,1,0,124,109,0,15,"CA E"
TRINITY,6105,8,6,0,0,2,0,0,0,0,0,8,6,0,2,"CA E"
TULARE,6107,827,695,5,1,126,21,13,5,1,2,806,682,0,124,"CA E"
TUOLUMNE,6109,112,91,0,0,21,6,4,0,0,2,106,87,0,19,"CA E"
VENTURA,6111,1,1,0,0,0,0,0,0,0,0,1,1,0,0,"CA E"
YOLO,6113,331,262,1,0,68,18,15,1,0,2,313,247,0,66,"CA E"
YUBA,6115,152,119,0,1,32,1,0,0,1,0,151,119,0,32,"CA E"
BREVARD,12009,1,1,0,0,0,0,0,0,0,0,1,1,0,0,"CA E"
PINELLAS,12103,1,0,0,0,1,0,0,0,0,0,1,0,0,1,"CA E"
HONOLULU,15003,1,1,0,0,0,0,0,0,0,0,1,1,0,0,"CA E"
ADA,16001,1,1,0,0,0,0,0,0,0,0,1,1,0,0,"CA E"
SEDGWICK,20173,1,1,0,0,0,0,0,0,0,0,1,1,0,0,"CA E"
"SAN JUAN",35045,1,0,0,0,1,0,0,0,0,0,1,0,0,1,"CA E"
STANLY,37167,1,0,0,0,1,0,0,0,0,0,1,0,0,1,"CA E"
BENTON,41003,1,0,0,0,1,0,0,0,0,0,1,0,0,1,"CA E"
DOUGLAS,41019,1,1,0,0,0,0,0,0,0,0,1,1,0,0,"CA E"
LANE,41039,1,1,0,0,0,0,0,0,0,0,1,1,0,0,"CA E"
HARRIS,48201,1,1,0,0,0,0,0,0,0,0,1,1,0,0,"CA E"
TARRANT,48439,1,0,0,0,1,0,0,0,0,0,1,0,0,1,"CA E"
"SALT LAKE",49035,1,1,0,0,0,0,0,0,0,0,1,1,0,0,"CA E"
CLARK,53011,1,1,0,0,0,0,0,0,0,0,1,1,0,0,"CA E"
"OUTSIDE HOME STATE",88888,1,1,0,0,0,0,0,0,0,0,1,1,0,0,"CA E"
"OUTSIDE U.S.",99999,1,1,0,0,0,0,0,0,0,0,1,1,0,0,"CA E"
MOBILE,1097,1,0,0,0,1,0,0,0,0,0,1,0,0,1,"CA N"
ALAMEDA,6001,2403,1416,22,0,965,111,75,18,0,18,2292,1341,4,947,"CA N"
CALAVERAS,6009,1,0,0,0,1,0,0,0,0,0,1,0,0,1,"CA N"
"CONTRA COSTA",6013,2281,1356,17,0,908,89,60,12,0,17,2192,1296,5,891,"CA N"
"DEL NORTE",6015,28,22,0,0,6,0,0,0,0,0,28,22,0,6,"CA N"
FRESNO,6019,6,5,0,0,1,0,0,0,0,0,6,5,0,1,"CA N"
GLENN,6021,1,0,0,0,1,0,0,0,0,0,1,0,0,1,"CA N"
HUMBOLDT,6023,112,87,2,0,23,5,2,2,0,1,107,85,0,22,"CA N"
LAKE,6033,99,89,0,0,10,3,3,0,0,0,96,86,0,10,"CA N"
"LOS ANGELES",6037,6,5,0,0,1,0,0,0,0,0,6,5,0,1,"CA N"
MARIN,6041,253,190,9,0,54,34,25,6,0,3,219,165,3,51,"CA N"
MENDOCINO,6045,129,96,1,1,31,4,2,1,1,0,125,94,0,31,"CA N"
MONTEREY,6053,1853,958,16,0,879,47,37,7,0,3,1806,921,9,876,"CA N"
NAPA,6055,176,126,3,0,47,19,15,3,0,1,157,111,0,46,"CA N"
ORANGE,6059,4,2,0,0,2,1,1,0,0,0,3,1,0,2,"CA N"
RIVERSIDE,6065,2,1,0,0,1,0,0,0,0,0,2,1,0,1,"CA N"
SACRAMENTO,6067,14,7,1,0,6,1,0,1,0,0,13,7,0,6,"CA N"
"SAN BENITO",6069,183,65,1,0,117,3,2,1,0,0,180,63,0,117,"CA N"
"SAN BERNARDINO",6071,1,0,0,0,1,0,0,0,0,0,1,0,0,1,"CA N"
"SAN DIEGO",6073,2,0,0,0,2,0,0,0,0,0,2,0,0,2,"CA N"
"SAN FRANCISCO",6075,683,409,17,0,257,78,58,12,0,8,605,351,5,249,"CA N"
"SAN JOAQUIN",6077,9,5,0,0,4,0,0,0,0,0,9,5,0,4,"CA N"
"SAN MATEO",6081,934,553,21,0,360,62,39,16,0,7,872,514,5,353,"CA N"
"SANTA BARBARA",6083,1,1,0,0,0,1,1,0,0,0,0,0,0,0,"CA N"
"SANTA CLARA",6085,2926,1600,36,0,1290,127,87,29,0,11,2799,1513,7,1279,"CA N"
"SANTA CRUZ",6087,455,277,4,2,172,22,14,3,2,3,433,263,1,169,"CA N"
SOLANO,6095,12,5,0,0,7,0,0,0,0,0,12,5,0,7,"CA N"
SONOMA,6097,832,620,15,2,194,48,31,10,2,4,784,589,5,190,"CA N"
STANISLAUS,6099,6,0,0,0,6,0,0,0,0,0,6,0,0,6,"CA N"
ARAPAHOE,8005,1,0,0,0,1,0,0,0,0,0,1,0,0,1,"CA N"
"EL PASO",8041,1,0,0,0,1,0,0,0,0,0,1,0,0,1,"CA N"
HARTFORD,9003,2,0,2,0,0,2,0,2,0,0,0,0,0,0,"CA N"
BROWARD,12011,1,1,0,0,0,1,1,0,0,0,0,0,0,0,"CA N"
MIAMI-DADE,12086,1,1,0,0,0,0,0,0,0,0,1,1,0,0,"CA N"
COBB,13067,1,0,0,0,1,0,0,0,0,0,1,0,0,1,"CA N"
PAULDING,13223,1,1,0,0,0,0,0,0,0,0,1,1,0,0,"CA N"
BLAINE,16013,1,0,1,0,0,1,0,1,0,0,0,0,0,0,"CA N"
COOK,17031,2,0,0,0,2,0,0,0,0,0,2,0,0,2,"CA N"
VANDERBURGH,18163,1,0,0,0,1,0,0,0,0,0,1,0,0,1,"CA N"
CECIL,24015,1,1,0,0,0,0,0,0,0,0,1,1,0,0,"CA N"
PASSAIC,34031,1,1,0,0,0,0,0,0,0,0,1,1,0,0,"CA N"
BEXAR,48029,1,0,0,0,1,0,0,0,0,0,1,0,0,1,"CA N"
TARRANT,48439,1,0,0,0,1,0,0,0,0,0,1,0,0,1,"CA N"
WILLIAMSON,48491,1,0,1,0,0,1,0,1,0,0,0,0,0,0,"CA N"
"SALT LAKE",49035,1,0,0,0,1,0,0,0,0,0,1,0,0,1,"CA N"
SPOKANE,53063,1,1,0,0,0,0,0,0,0,0,1,1,0,0,"CA N"
"OUTSIDE HOME STATE",88888,1,0,0,0,1,0,0,0,0,0,1,0,0,1,"CA N"
"CONTRA COSTA",6013,1,1,0,0,0,0,0,0,0,0,1,1,0,0,"CA S"
FRESNO,6019,1,0,0,0,1,0,0,0,0,0,1,0,0,1,"CA S"
IMPERIAL,6025,422,371,1,0,50,6,3,1,0,2,416,368,0,48,"CA S"
KERN,6029,2,1,0,0,1,0,0,0,0,0,2,1,0,1,"CA S"
"LOS ANGELES",6037,10,6,1,0,3,2,1,1,0,0,8,5,0,3,"CA S"
ORANGE,6059,5,4,0,0,1,1,1,0,0,0,4,3,0,1,"CA S"
RIVERSIDE,6065,20,13,0,0,7,0,0,0,0,0,20,13,0,7,"CA S"
"SAN BERNARDINO",6071,1,1,0,0,0,0,0,0,0,0,1,1,0,0,"CA S"
"SAN DIEGO",6073,9521,7640,38,0,1842,367,293,27,0,46,9154,7347,11,1796,"CA S"
"SAN FRANCISCO",6075,1,1,0,0,0,0,0,0,0,0,1,1,0,0,"CA S"
"SAN LUIS OBISPO",6079,1,1,0,0,0,0,0,0,0,0,1,1,0,0,"CA S"
"SANTA BARBARA",6083,2,0,0,0,2,0,0,0,0,0,2,0,0,2,"CA S"
"SANTA CLARA",6085,1,1,0,0,0,0,0,0,0,0,1,1,0,0,"CA S"
TUOLUMNE,6109,1,1,0,0,0,0,0,0,0,0,1,1,0,0,"CA S"
VENTURA,6111,3,2,0,0,1,0,0,0,0,0,3,2,0,1,"CA S"
ARAPAHOE,8005,1,1,0,0,0,0,0,0,0,0,1,1,0,0,"CA S"
DUVAL,12031,1,0,0,0,1,0,0,0,0,0,1,0,0,1,"CA S"
BONNEVILLE,16019,1,1,0,0,0,0,0,0,0,0,1,1,0,0,"CA S"
KANE,17089,1,0,0,0,1,0,0,0,0,0,1,0,0,1,"CA S"
SARPY,31153,1,0,0,0,1,0,0,0,0,0,1,0,0,1,"CA S"
BRUNSWICK,37019,1,1,0,0,0,0,0,0,0,0,1,1,0,0,"CA S"
COLUMBIANA,39029,1,1,0,0,0,0,0,0,0,0,1,1,0,0,"CA S"
COLUMBIA,41009,1,1,0,0,0,0,0,0,0,0,1,1,0,0,"CA S"
SHELBY,47157,1,1,0,0,0,0,0,0,0,0,1,1,0,0,"CA S"
"OUTSIDE HOME STATE",88888,1,1,0,0,0,0,0,0,0,0,1,1,0,0,"CA S"
"OUTSIDE U.S.",99999,2,2,0,0,0,0,0,0,0,0,2,2,0,0,"CA S"
MADISON,1089,1,1,0,0,0,0,0,0,0,0,1,1,0,0,CO
BENTON,5007,1,0,0,0,1,0,0,0,0,0,1,0,0,1,CO
"LOS ANGELES",6037,1,0,0,0,1,0,0,0,0,0,1,0,0,1,CO
"SAN DIEGO",6073,1,0,0,0,1,0,0,0,0,0,1,0,0,1,CO
"SAN JOAQUIN",6077,1,0,0,0,1,0,0,0,0,0,1,0,0,1,CO
ADAMS,8001,2161,1756,6,0,399,22,14,6,0,2,2139,1742,0,397,CO
ALAMOSA,8003,47,43,0,0,4,1,1,0,0,0,46,42,0,4,CO
ARAPAHOE,8005,2595,2150,6,0,439,52,40,6,0,6,2543,2110,0,433,CO
ARCHULETA,8007,11,11,0,0,0,0,0,0,0,0,11,11,0,0,CO
BACA,8009,6,6,0,0,0,0,0,0,0,0,6,6,0,0,CO
BENT,8011,9,9,0,0,0,0,0,0,0,0,9,9,0,0,CO
BOULDER,8013,531,464,1,0,66,27,23,1,0,3,504,441,0,63,CO
BROOMFIELD,8014,137,112,0,0,25,5,4,0,0,1,132,108,0,24,CO
CHAFFEE,8015,25,21,1,0,3,1,1,0,0,0,24,20,1,3,CO
CHEYENNE,8017,2,2,0,0,0,0,0,0,0,0,2,2,0,0,CO
"CLEAR CREEK",8019,27,22,0,0,5,2,2,0,0,0,25,20,0,5,CO
CONEJOS,8021,13,12,0,0,1,0,0,0,0,0,13,12,0,1,CO
COSTILLA,8023,7,7,0,0,0,0,0,0,0,0,7,7,0,0,CO
CROWLEY,8025,8,5,0,0,3,0,0,0,0,0,8,5,0,3,CO
CUSTER,8027,6,4,0,0,2,0,0,0,0,0,6,4,0,2,CO
DELTA,8029,84,82,0,1,1,4,3,0,1,0,80,79,0,1,CO
DENVER,8031,2248,1893,13,0,339,66,50,13,0,0,2182,1843,0,339,CO
DOLORES,8033,1,1,0,0,0,0,0,0,0,0,1,1,0,0,CO
DOUGLAS,8035,775,582,3,1,188,39,32,1,1,4,736,550,2,184,CO
EAGLE,8037,82,72,1,0,9,8,8,0,0,0,74,64,1,9,CO
ELBERT,8039,69,57,0,0,12,4,3,0,0,1,65,54,0,11,CO
"EL PASO",8041,2139,1816,6,0,317,46,37,6,0,3,2093,1779,0,314,CO
FREMONT,8043,113,96,0,0,17,1,1,0,0,0,112,95,0,17,CO
GARFIELD,8045,118,108,1,0,9,8,7,1,0,0,110,101,0,9,CO
GILPIN,8047,18,16,0,0,2,0,0,0,0,0,18,16,0,2,CO
GRAND,8049,27,23,0,0,4,2,2,0,0,0,25,21,0,4,CO
GUNNISON,8051,18,17,1,0,0,3,2,1,0,0,15,15,0,0,CO
HUERFANO,8055,14,13,0,0,1,0,0,0,0,0,14,13,0,1,CO
JACKSON,8057,1,1,0,0,0,0,0,0,0,0,1,1,0,0,CO
JEFFERSON,8059,1960,1632,11,0,317,55,45,9,0,1,1905,1587,2,316,CO
KIOWA,8061,2,2,0,0,0,0,0,0,0,0,2,2,0,0,CO
"KIT CARSON",8063,18,17,0,0,1,0,0,0,0,0,18,17,0,1,CO
LAKE,8065,7,7,0,0,0,0,0,0,0,0,7,7,0,0,CO
"LA PLATA",8067,52,48,0,0,4,4,4,0,0,0,48,44,0,4,CO
LARIMER,8069,805,682,4,0,119,28,21,4,0,3,777,661,0,116,CO
"LAS ANIMAS",8071,31,25,2,0,4,3,1,2,0,0,28,24,0,4,CO
LINCOLN,8073,10,9,0,0,1,0,0,0,0,0,10,9,0,1,CO
LOGAN,8075,26,21,0,0,5,0,0,0,0,0,26,21,0,5,CO
MESA,8077,521,438,2,0,81,12,9,1,0,2,509,429,1,79,CO
MINERAL,8079,1,1,0,0,0,0,0,0,0,0,1,1,0,0,CO
MOFFAT,8081,30,19,0,0,11,1,1,0,0,0,29,18,0,11,CO
MONTEZUMA,8083,31,25,0,0,6,2,2,0,0,0,29,23,0,6,CO
MONTROSE,8085,94,79,2,0,13,4,2,2,0,0,90,77,0,13,CO
MORGAN,8087,56,46,0,0,10,2,2,0,0,0,54,44,0,10,CO
OTERO,8089,50,44,1,0,5,3,2,1,0,0,47,42,0,5,CO
OURAY,8091,9,8,0,0,1,1,1,0,0,0,8,7,0,1,CO
PARK,8093,39,29,0,0,10,0,0,0,0,0,39,29,0,10,CO
PHILLIPS,8095,4,3,0,0,1,0,0,0,0,0,4,3,0,1,CO
PITKIN,8097,14,9,1,0,4,4,3,1,0,0,10,6,0,4,CO
PROWERS,8099,11,9,0,0,2,0,0,0,0,0,11,9,0,2,CO
PUEBLO,8101,795,697,4,0,94,11,7,4,0,0,784,690,0,94,CO
"RIO BLANCO",8103,12,11,0,0,1,1,0,0,0,1,11,11,0,0,CO
"RIO GRANDE",8105,29,26,0,0,3,1,1,0,0,0,28,25,0,3,CO
ROUTT,8107,48,38,0,0,10,2,2,0,0,0,46,36,0,10,CO
SAGUACHE,8109,13,13,0,0,0,0,0,0,0,0,13,13,0,0,CO
"SAN MIGUEL",8113,17,13,3,0,1,2,0,2,0,0,15,13,1,1,CO
SEDGWICK,8115,6,5,0,1,0,1,0,0,1,0,5,5,0,0,CO
SUMMIT,8117,37,34,0,0,3,3,3,0,0,0,34,31,0,3,CO
TELLER,8119,67,56,0,0,11,4,4,0,0,0,63,52,0,11,CO
WASHINGTON,8121,6,4,0,1,1,1,0,0,1,0,5,4,0,1,CO
WELD,8123,795,657,0,0,138,15,14,0,0,1,780,643,0,137,CO
YUMA,8125,15,13,0,0,2,0,0,0,0,0,15,13,0,2,CO
BROWARD,12011,1,0,0,0,1,0,0,0,0,0,1,0,0,1,CO
OSCEOLA,12097,1,1,0,0,0,0,0,0,0,0,1,1,0,0,CO
"ST. JOHNS",12109,1,1,0,0,0,0,0,0,0,0,1,1,0,0,CO
SEMINOLE,12117,2,1,0,0,1,0,0,0,0,0,2,1,0,1,CO
COBB,13067,1,0,0,0,1,0,0,0,0,0,1,0,0,1,CO
FULTON,13121,1,1,0,0,0,0,0,0,0,0,1,1,0,0,CO
HAWAII,15001,1,1,0,0,0,1,1,0,0,0,0,0,0,0,CO
JACKSON,17077,1,1,0,0,0,0,0,0,0,0,1,1,0,0,CO
KOSCIUSKO,18085,1,1,0,0,0,0,0,0,0,0,1,1,0,0,CO
MARION,18097,1,0,0,0,1,0,0,0,0,0,1,0,0,1,CO
PORTER,18127,1,0,0,0,1,0,0,0,0,0,1,0,0,1,CO
WAYNE,18177,1,0,0,0,1,0,0,0,0,0,1,0,0,1,CO
GREENWOOD,20073,1,0,0,0,1,0,0,0,0,0,1,0,0,1,CO
POTTAWATOMIE,20149,1,0,0,0,1,0,0,0,0,0,1,0,0,1,CO
SEDGWICK,20173,1,1,0,0,0,0,0,0,0,0,1,1,0,0,CO
BOSSIER,22015,1,0,0,0,1,0,0,0,0,0,1,0,0,1,CO
PIKE,28113,1,0,0,0,1,0,0,0,0,0,1,0,0,1,CO
JACKSON,29095,1,1,0,0,0,0,0,0,0,0,1,1,0,0,CO
"ST. LOUIS CITY",29510,1,1,0,0,0,0,0,0,0,0,1,1,0,0,CO
DOUGLAS,31055,1,0,0,0,1,0,0,0,0,0,1,0,0,1,CO
BERNALILLO,35001,2,0,0,0,2,0,0,0,0,0,2,0,0,2,CO
"DONA ANA",35013,1,0,0,0,1,0,0,0,0,0,1,0,0,1,CO
CUMBERLAND,37051,1,0,0,0,1,0,0,0,0,0,1,0,0,1,CO
IREDELL,37097,1,1,0,0,0,0,0,0,0,0,1,1,0,0,CO
CROOK,41013,1,0,0,0,1,0,0,0,0,0,1,0,0,1,CO
MARION,41047,1,0,0,0,1,0,0,0,0,0,1,0,0,1,CO
UMATILLA,41059,1,1,0,0,0,0,0,0,0,0,1,1,0,0,CO
WASHINGTON,41067,1,1,0,0,0,0,0,0,0,0,1,1,0,0,CO
RICHLAND,45079,1,1,0,0,0,0,0,0,0,0,1,1,0,0,CO
BRADLEY,47011,1,0,0,0,1,0,0,0,0,0,1,0,0,1,CO
MADISON,47113,1,1,0,0,0,0,0,0,0,0,1,1,0,0,CO
BEXAR,48029,1,0,0,0,1,0,0,0,0,0,1,0,0,1,CO
DALLAS,48113,3,1,0,0,2,0,0,0,0,0,3,1,0,2,CO
TARRANT,48439,1,0,0,0,1,0,0,0,0,0,1,0,0,1,CO
IRON,49021,1,0,0,0,1,0,0,0,0,0,1,0,0,1,CO
KING,53033,1,1,0,0,0,0,0,0,0,0,1,1,0,0,CO
SNOHOMISH,53061,1,1,0,0,0,0,0,0,0,0,1,1,0,0,CO
LARAMIE,56021,1,1,0,0,0,0,0,0,0,0,1,1,0,0,CO
"DISTRICT OF COLUMBIA",11001,762,616,26,0,120,52,27,22,0,3,710,589,4,117,DC
"ANNE ARUNDEL",24003,1,0,0,0,1,0,0,0,0,0,1,0,0,1,DC
MONTGOMERY,24031,3,1,2,0,0,2,0,2,0,0,1,1,0,0,DC
"PRINCE GEORGE'S",24033,10,7,0,0,3,0,0,0,0,0,10,7,0,3,DC
WASHINGTON,24043,1,1,0,0,0,0,0,0,0,0,1,1,0,0,DC
"BALTIMORE (CITY)",24510,1,1,0,0,0,1,1,0,0,0,0,0,0,0,DC
SUFFOLK,25025,3,0,3,0,0,3,0,3,0,0,0,0,0,0,DC
PETTIS,29159,1,0,0,0,1,0,0,0,0,0,1,0,0,1,DC
HALIFAX,37083,1,0,0,0,1,0,0,0,0,0,1,0,0,1,DC
FAIRFAX,51059,2,0,1,0,1,1,0,1,0,0,1,0,0,1,DC
SPOTSYLVANIA,51177,1,1,0,0,0,0,0,0,0,0,1,1,0,0,DC
MARICOPA,4013,2,0,2,0,0,2,0,2,0,0,0,0,0,0,DE
MOHAVE,4015,2,0,2,0,0,2,0,2,0,0,0,0,0,0,DE
"LOS ANGELES",6037,12,1,11,0,0,12,1,11,0,0,0,0,0,0,DE
ORANGE,6059,4,0,4,0,0,4,0,4,0,0,0,0,0,0,DE
"SAN FRANCISCO",6075,2,0,2,0,0,2,0,2,0,0,0,0,0,0,DE
"SANTA BARBARA",6083,22,0,22,0,0,22,0,22,0,0,0,0,0,0,DE
ARAPAHOE,8005,10,1,9,0,0,10,1,9,0,0,0,0,0,0,DE
DENVER,8031,1,1,0,0,0,1,1,0,0,0,0,0,0,0,DE
JEFFERSON,8059,1,0,1,0,0,1,0,1,0,0,0,0,0,0,DE
LARIMER,8069,3,0,3,0,0,3,0,3,0,0,0,0,0,0,DE
WELD,8123,1,1,0,0,0,1,1,0,0,0,0,0,0,0,DE
KENT,10001,483,336,0,1,146,7,6,0,1,0,476,330,0,146,DE
"NEW CASTLE",10003,1459,895,38,0,525,80,35,37,0,7,1379,860,1,518,DE
SUSSEX,10005,428,331,3,2,92,10,5,3,1,1,418,326,0,91,DE
"DISTRICT OF COLUMBIA",11001,2,0,2,0,0,2,0,2,0,0,0,0,0,0,DE
BROWARD,12011,6,3,3,0,0,6,3,3,0,0,0,0,0,0,DE
COLLIER,12021,3,0,3,0,0,3,0,3,0,0,0,0,0,0,DE
HILLSBOROUGH,12057,12,0,12,0,0,12,0,12,0,0,0,0,0,0,DE
LEE,12071,2,0,2,0,0,2,0,2,0,0,0,0,0,0,DE
MARION,12083,1,0,0,0,1,0,0,0,0,0,1,0,0,1,DE
"PALM BEACH",12099,2,1,1,0,0,2,1,1,0,0,0,0,0,0,DE
COBB,13067,1,1,0,0,0,0,0,0,0,0,1,1,0,0,DE
COWETA,13077,1,1,0,0,0,1,1,0,0,0,0,0,0,0,DE
DEKALB,13089,1,0,1,0,0,1,0,1,0,0,0,0,0,0,DE
BONNER,16017,8,0,8,0,0,8,0,8,0,0,0,0,0,0,DE
COOK,17031,11,7,4,0,0,11,7,4,0,0,0,0,0,0,DE
PENOBSCOT,23019,1,1,0,0,0,1,1,0,0,0,0,0,0,0,DE
CAROLINE,24011,1,1,0,0,0,0,0,0,0,0,1,1,0,0,DE
CECIL,24015,6,4,0,0,2,1,1,0,0,0,5,3,0,2,DE
FREDERICK,24021,1,0,0,0,1,0,0,0,0,0,1,0,0,1,DE
"PRINCE GEORGE'S",24033,1,0,0,0,1,0,0,0,0,0,1,0,0,1,DE
WICOMICO,24045,1,1,0,0,0,0,0,0,0,0,1,1,0,0,DE
"BALTIMORE (CITY)",24510,1,1,0,0,0,0,0,0,0,0,1,1,0,0,DE
BARNSTABLE,25001,18,0,18,0,0,18,0,18,0,0,0,0,0,0,DE
MIDDLESEX,25017,2,1,1,0,0,2,1,1,0,0,0,0,0,0,DE
NORFOLK,25021,2,0,2,0,0,2,0,2,0,0,0,0,0,0,DE
SUFFOLK,25025,2,0,2,0,0,2,0,2,0,0,0,0,0,0,DE
OAKLAND,26125,31,31,0,0,0,31,31,0,0,0,0,0,0,0,DE
DAKOTA,27037,4,0,4,0,0,4,0,4,0,0,0,0,0,0,DE
FREEBORN,27047,1,0,1,0,0,1,0,1,0,0,0,0,0,0,DE
HENNEPIN,27053,3,0,3,0,0,3,0,3,0,0,0,0,0,0,DE
TATE,28137,1,0,1,0,0,1,0,1,0,0,0,0,0,0,DE
JACKSON,29095,1,0,1,0,0,1,0,1,0,0,0,0,0,0,DE
MISSOULA,30063,1,0,1,0,0,1,0,1,0,0,0,0,0,0,DE
CLARK,32003,24,0,24,0,0,24,0,24,0,0,0,0,0,0,DE
HUMBOLDT,32013,1,0,1,0,0,1,0,1,0,0,0,0,0,0,DE
WASHOE,32031,13,0,13,0,0,13,0,13,0,0,0,0,0,0,DE
HILLSBOROUGH,33011,12,0,12,0,0,12,0,12,0,0,0,0,0,0,DE
ATLANTIC,34001,8,0,8,0,0,8,0,8,0,0,0,0,0,0,DE
BURLINGTON,34005,1,1,0,0,0,0,0,0,0,0,1,1,0,0,DE
CUMBERLAND,34011,1,0,0,0,1,0,0,0,0,0,1,0,0,1,DE
ESSEX,34013,1,1,0,0,0,0,0,0,0,0,1,1,0,0,DE
MIDDLESEX,34023,5,0,5,0,0,5,0,5,0,0,0,0,0,0,DE
OCEAN,34029,1,0,1,0,0,1,0,1,0,0,0,0,0,0,DE
SALEM,34033,1,1,0,0,0,0,0,0,0,0,1,1,0,0,DE
ALBANY,36001,1,0,1,0,0,1,0,1,0,0,0,0,0,0,DE
"NEW YORK",36061,27,8,19,0,0,27,8,19,0,0,0,0,0,0,DE
ONTARIO,36069,1,1,0,0,0,1,1,0,0,0,0,0,0,0,DE
DURHAM,37063,4,0,4,0,0,4,0,4,0,0,0,0,0,0,DE
FORSYTH,37067,2,2,0,0,0,2,2,0,0,0,0,0,0,0,DE
MECKLENBURG,37119,4,0,4,0,0,4,0,4,0,0,0,0,0,0,DE
CUYAHOGA,39035,1,0,1,0,0,1,0,1,0,0,0,0,0,0,DE
HAMILTON,39061,3,0,3,0,0,3,0,3,0,0,0,0,0,0,DE
MEDINA,39103,1,0,1,0,0,1,0,1,0,0,0,0,0,0,DE
MONTGOMERY,39113,5,0,5,0,0,5,0,5,0,0,0,0,0,0,DE
TULSA,40143,1,0,1,0,0,1,0,1,0,0,0,0,0,0,DE
JACKSON,41029,2,0,2,0,0,2,0,2,0,0,0,0,0,0,DE
ALLEGHENY,42003,1,0,1,0,0,1,0,1,0,0,0,0,0,0,DE
BERKS,42011,5,0,5,0,0,5,0,5,0,0,0,0,0,0,DE
CHESTER,42029,3,2,0,0,1,1,1,0,0,0,2,1,0,1,DE
DELAWARE,42045,5,5,0,0,0,4,4,0,0,0,1,1,0,0,DE
MONTGOMERY,42091,11,0,11,0,0,11,0,11,0,0,0,0,0,0,DE
PHILADELPHIA,42101,1,0,0,0,1,0,0,0,0,0,1,0,0,1,DE
DAVIDSON,47037,1,0,1,0,0,1,0,1,0,0,0,0,0,0,DE
HAMBLEN,47063,7,0,7,0,0,7,0,7,0,0,0,0,0,0,DE
BASTROP,48021,1,0,1,0,0,1,0,1,0,0,0,0,0,0,DE
DALLAS,48113,72,0,72,0,0,72,0,72,0,0,0,0,0,0,DE
HARRIS,48201,17,0,17,0,0,17,0,17,0,0,0,0,0,0,DE
TARRANT,48439,32,0,32,0,0,32,0,32,0,0,0,0,0,0,DE
"SALT LAKE",49035,1,0,1,0,0,1,0,1,0,0,0,0,0,0,DE
FAIRFAX,51059,3,0,3,0,0,3,0,3,0,0,0,0,0,0,DE
"FAIRFAX (CITY)",51600,11,0,11,0,0,11,0,11,0,0,0,0,0,0,DE
"RICHMOND (CITY)",51760,1,0,1,0,0,1,0,1,0,0,0,0,0,0,DE
KING,53033,2,0,2,0,0,2,0,2,0,0,0,0,0,0,DE
GUAYNABO,72061,1,0,1,0,0,1,0,1,0,0,0,0,0,0,DE
"ST. THOMAS",78030,1,0,1,0,0,1,0,1,0,0,0,0,0,0,DE
"OUTSIDE HOME STATE",88888,33,18,14,0,1,22,8,14,0,0,11,10,0,1,DE
"OUTSIDE U.S.",99999,15,0,6,0,0,15,0,6,0,0,0,0,0,0,DE
AUTAUGA,1001,4,2,0,0,2,0,0,0,0,0,4,2,0,2,"FL M"
PULASKI,5119,1,1,0,0,0,0,0,0,0,0,1,1,0,0,"FL M"
KINGS,6031,1,1,0,0,0,0,0,0,0,0,1,1,0,0,"FL M"
"LOS ANGELES",6037,2,2,0,0,0,0,0,0,0,0,2,2,0,0,"FL M"
ORANGE,6059,2,0,1,0,1,1,0,1,0,0,1,0,0,1,"FL M"
"SAN MATEO",6081,1,0,0,0,1,0,0,0,0,0,1,0,0,1,"FL M"
ARAPAHOE,8005,2,1,0,0,1,0,0,0,0,0,2,1,0,1,"FL M"
DOUGLAS,8035,1,0,0,0,1,0,0,0,0,0,1,0,0,1,"FL M"
GILPIN,8047,1,1,0,0,0,0,0,0,0,0,1,1,0,0,"FL M"
JEFFERSON,8059,1,0,0,0,1,0,0,0,0,0,1,0,0,1,"FL M"
FAIRFIELD,9001,1,0,0,0,1,0,0,0,0,0,1,0,0,1,"FL M"
ALACHUA,12001,10,5,0,0,5,0,0,0,0,0,10,5,0,5,"FL M"
BAKER,12003,43,20,2,0,21,2,0,2,0,0,41,20,0,21,"FL M"
BAY,12005,1,1,0,0,0,0,0,0,0,0,1,1,0,0,"FL M"
BRADFORD,12007,29,21,0,0,8,2,1,0,0,1,27,20,0,7,"FL M"
BREVARD,12009,1507,1230,9,0,268,48,36,8,0,4,1459,1194,1,264,"FL M"
BROWARD,12011,23,15,0,0,8,2,2,0,0,0,21,13,0,8,"FL M"
CHARLOTTE,12015,390,256,2,0,132,17,13,2,0,2,373,243,0,130,"FL M"
CITRUS,12017,362,292,3,1,66,19,15,2,1,1,343,277,1,65,"FL M"
CLAY,12019,590,373,5,0,212,14,10,3,0,1,576,363,2,211,"FL M"
COLLIER,12021,1363,737,14,2,610,75,56,13,2,4,1288,681,1,606,"FL M"
COLUMBIA,12023,108,71,5,2,30,8,1,5,2,0,100,70,0,30,"FL M"
DESOTO,12027,40,23,0,0,17,1,1,0,0,0,39,22,0,17,"FL M"
DIXIE,12029,3,1,1,0,1,1,0,1,0,0,2,1,0,1,"FL M"
DUVAL,12031,2973,1739,58,0,1176,102,60,39,0,3,2871,1679,19,1173,"FL M"
FLAGLER,12035,340,257,4,0,79,9,6,3,0,0,331,251,1,79,"FL M"
FRANKLIN,12037,1,0,1,0,0,0,0,0,0,0,1,0,1,0,"FL M"
GILCHRIST,12041,1,1,0,0,0,0,0,0,0,0,1,1,0,0,"FL M"
GLADES,12043,162,96,2,0,64,9,6,2,0,1,153,90,0,63,"FL M"
HAMILTON,12047,20,9,1,0,10,1,0,1,0,0,19,9,0,10,"FL M"
HARDEE,12049,20,13,0,0,7,0,0,0,0,0,20,13,0,7,"FL M"
HENDRY,12051,37,21,0,0,16,1,1,0,0,0,36,20,0,16,"FL M"
HERNANDO,12053,525,407,7,0,111,18,9,5,0,4,507,398,2,107,"FL M"
HIGHLANDS,12055,18,13,3,0,2,3,0,3,0,0,15,13,0,2,"FL M"
HILLSBOROUGH,12057,3992,2535,75,2,1380,181,99,62,2,18,3811,2436,13,1362,"FL M"
"INDIAN RIVER",12061,5,3,0,0,2,2,1,0,0,1,3,2,0,1,"FL M"
LAFAYETTE,12067,2,1,0,1,0,1,0,0,1,0,1,1,0,0,"FL M"
LAKE,12069,1087,855,5,0,227,31,26,4,0,1,1056,829,1,226,"FL M"
LEE,12071,1673,1056,11,1,605,72,54,9,1,8,1601,1002,2,597,"FL M"
LEON,12073,1,1,0,0,0,0,0,0,0,0,1,1,0,0,"FL M"
LEVY,12075,10,7,0,0,3,1,0,0,0,1,9,7,0,2,"FL M"
MADISON,12079,1,1,0,0,0,0,0,0,0,0,1,1,0,0,"FL M"
MANATEE,12081,789,500,12,0,277,36,20,11,0,5,753,480,1,272,"FL M"
MARION,12083,808,701,2,2,103,34,30,2,2,0,774,671,0,103,"FL M"
MARTIN,12085,5,3,0,0,2,0,0,0,0,0,5,3,0,2,"FL M"
MIAMI-DADE,12086,19,10,0,0,9,0,0,0,0,0,19,10,0,9,"FL M"
MONROE,12087,4,3,0,0,1,2,2,0,0,0,2,1,0,1,"FL M"
NASSAU,12089,191,125,1,0,65,4,4,0,0,0,187,121,1,65,"FL M"
OKEECHOBEE,12093,4,2,0,0,2,0,0,0,0,0,4,2,0,2,"FL M"
ORANGE,12095,5249,3816,37,0,1396,188,141,34,0,13,5061,3675,3,1383,"FL M"
OSCEOLA,12097,1475,1140,7,0,327,29,20,7,0,1,1446,1120,0,326,"FL M"
"PALM BEACH",12099,12,6,1,0,5,0,0,0,0,0,12,6,1,5,"FL M"
PASCO,12101,1458,986,11,1,460,42,28,8,1,5,1416,958,3,455,"FL M"
PINELLAS,12103,2807,1867,32,0,908,99,64,23,0,12,2708,1803,9,896,"FL M"
POLK,12105,1544,1062,15,0,467,40,28,10,0,2,1504,1034,5,465,"FL M"
PUTNAM,12107,114,81,3,0,30,6,3,3,0,0,108,78,0,30,"FL M"
"ST. JOHNS",12109,421,267,15,0,139,31,22,7,0,2,390,245,8,137,"FL M"
"ST. LUCIE",12111,2,1,1,0,0,1,0,1,0,0,1,1,0,0,"FL M"
SARASOTA,12115,1005,695,12,0,298,52,38,9,0,5,953,657,3,293,"FL M"
SEMINOLE,12117,1606,1238,6,0,362,67,58,4,0,5,1539,1180,2,357,"FL M"
SUMTER,12119,119,107,0,0,12,8,7,0,0,1,111,100,0,11,"FL M"
SUWANNEE,12121,52,27,1,2,22,3,0,1,2,0,49,27,0,22,"FL M"
UNION,12125,19,7,3,1,8,4,0,2,1,1,15,7,1,7,"FL M"
VOLUSIA,12127,1811,1404,7,0,400,53,46,4,0,3,1758,1358,3,397,"FL M"
WALTON,12131,1,1,0,0,0,0,0,0,0,0,1,1,0,0,"FL M"
BIBB,13021,1,0,0,0,1,0,0,0,0,0,1,0,0,1,"FL M"
CAMDEN,13039,1,1,0,0,0,0,0,0,0,0,1,1,0,0,"FL M"
CATOOSA,13047,1,1,0,0,0,0,0,0,0,0,1,1,0,0,"FL M"
CHATHAM,13051,1,1,0,0,0,0,0,0,0,0,1,1,0,0,"FL M"
CHEROKEE,13057,1,1,0,0,0,0,0,0,0,0,1,1,0,0,"FL M"
DEKALB,13089,1,0,0,0,1,0,0,0,0,0,1,0,0,1,"FL M"
DOUGLAS,13097,1,0,0,0,1,0,0,0,0,0,1,0,0,1,"FL M"
FORSYTH,13117,1,0,1,0,0,1,0,1,0,0,0,0,0,0,"FL M"
FULTON,13121,2,0,0,0,2,0,0,0,0,0,2,0,0,2,"FL M"
GILMER,13123,1,1,0,0,0,0,0,0,0,0,1,1,0,0,"FL M"
HENRY,13151,1,1,0,0,0,0,0,0,0,0,1,1,0,0,"FL M"
LOWNDES,13185,2,0,0,0,2,0,0,0,0,0,2,0,0,2,"FL M"
ROCKDALE,13247,1,1,0,0,0,0,0,0,0,0,1,1,0,0,"FL M"
WARE,13299,1,1,0,0,0,0,0,0,0,0,1,1,0,0,"FL M"
ADA,16001,1,0,0,0,1,0,0,0,0,0,1,0,0,1,"FL M"
DUPAGE,17043,2,1,0,0,1,0,0,0,0,0,2,1,0,1,"FL M"
KENDALL,17093,1,1,0,0,0,0,0,0,0,0,1,1,0,0,"FL M"
PEORIA,17143,1,1,0,0,0,0,0,0,0,0,1,1,0,0,"FL M"
LAKE,18089,1,1,0,0,0,0,0,0,0,0,1,1,0,0,"FL M"
MARION,18097,2,1,0,0,1,0,0,0,0,0,2,1,0,1,"FL M"
"EAST BATON ROUGE",22033,1,0,0,0,1,0,0,0,0,0,1,0,0,1,"FL M"
JACKSON,22049,1,1,0,0,0,0,0,0,0,0,1,1,0,0,"FL M"
TERREBONNE,22109,1,1,0,0,0,0,0,0,0,0,1,1,0,0,"FL M"
"ANNE ARUNDEL",24003,1,0,0,0,1,0,0,0,0,0,1,0,0,1,"FL M"
"BALTIMORE (COUNTY,NOT CITY)",24005,1,0,0,0,1,0,0,0,0,0,1,0,0,1,"FL M"
BARNSTABLE,25001,1,0,0,0,1,0,0,0,0,0,1,0,0,1,"FL M"
BRISTOL,25005,1,0,0,0,1,0,0,0,0,0,1,0,0,1,"FL M"
EMMET,26047,1,1,0,0,0,0,0,0,0,0,1,1,0,0,"FL M"
KALAMAZOO,26077,1,0,1,0,0,1,0,1,0,0,0,0,0,0,"FL M"
KENT,26081,1,1,0,0,0,0,0,0,0,0,1,1,0,0,"FL M"
TUSCOLA,26157,1,0,0,0,1,0,0,0,0,0,1,0,0,1,"FL M"
BERGEN,34003,1,0,0,0,1,0,0,0,0,0,1,0,0,1,"FL M"
MERCER,34021,2,2,0,0,0,0,0,0,0,0,2,2,0,0,"FL M"
OCEAN,34029,1,1,0,0,0,0,0,0,0,0,1,1,0,0,"FL M"
BERNALILLO,35001,1,1,0,0,0,0,0,0,0,0,1,1,0,0,"FL M"
ALBANY,36001,1,0,0,0,1,0,0,0,0,0,1,0,0,1,"FL M"
BRONX,36005,3,3,0,0,0,0,0,0,0,0,3,3,0,0,"FL M"
KINGS,36047,1,0,0,0,1,0,0,0,0,0,1,0,0,1,"FL M"
MONROE,36055,2,0,0,0,2,0,0,0,0,0,2,0,0,2,"FL M"
QUEENS,36081,2,1,0,0,1,0,0,0,0,0,2,1,0,1,"FL M"
SUFFOLK,36103,1,1,0,0,0,0,0,0,0,0,1,1,0,0,"FL M"
CHEROKEE,37039,1,1,0,0,0,0,0,0,0,0,1,1,0,0,"FL M"
UNION,37179,1,1,0,0,0,0,0,0,0,0,1,1,0,0,"FL M"
HAMILTON,39061,1,1,0,0,0,0,0,0,0,0,1,1,0,0,"FL M"
MONTGOMERY,39113,1,0,0,0,1,0,0,0,0,0,1,0,0,1,"FL M"
MUSKINGUM,39119,1,1,0,0,0,0,0,0,0,0,1,1,0,0,"FL M"
SUMMIT,39153,1,0,0,0,1,0,0,0,0,0,1,0,0,1,"FL M"
CHESTER,42029,1,0,0,0,1,0,0,0,0,0,1,0,0,1,"FL M"
ERIE,42049,1,0,0,0,1,0,0,0,0,0,1,0,0,1,"FL M"
LEHIGH,42077,1,1,0,0,0,0,0,0,0,0,1,1,0,0,"FL M"
SCHUYLKILL,42107,1,1,0,0,0,0,0,0,0,0,1,1,0,0,"FL M"
GREENVILLE,45045,1,1,0,0,0,0,0,0,0,0,1,1,0,0,"FL M"
KNOX,47093,1,1,0,0,0,0,0,0,0,0,1,1,0,0,"FL M"
BRAZORIA,48039,1,0,0,0,1,1,0,0,0,1,0,0,0,0,"FL M"
GALVESTON,48167,1,0,0,0,1,0,0,0,0,0,1,0,0,1,"FL M"
TARRANT,48439,2,1,0,0,1,0,0,0,0,0,2,1,0,1,"FL M"
WEBER,49057,1,0,0,0,1,0,0,0,0,0,1,0,0,1,"FL M"
CHESTERFIELD,51041,1,1,0,0,0,0,0,0,0,0,1,1,0,0,"FL M"
"ISLE OF WIGHT",51093,1,0,0,0,1,0,0,0,0,0,1,0,0,1,"FL M"
"PRINCE WILLIAM",51153,2,1,0,0,1,0,0,0,0,0,2,1,0,1,"FL M"
SOUTHAMPTON,51175,1,1,0,0,0,0,0,0,0,0,1,1,0,0,"FL M"
"NORFOLK (CITY)",51710,1,0,0,0,1,0,0,0,0,0,1,0,0,1,"FL M"
CLARK,53011,1,1,0,0,0,0,0,0,0,0,1,1,0,0,"FL M"
PIERCE,53053,1,1,0,0,0,0,0,0,0,0,1,1,0,0,"FL M"
SPOKANE,53063,1,1,0,0,0,0,0,0,0,0,1,1,0,0,"FL M"
MILWAUKEE,55079,1,1,0,0,0,0,0,0,0,0,1,1,0,0,"FL M"
"SAN JUAN",72127,1,1,0,0,0,1,1,0,0,0,0,0,0,0,"FL M"
"TRUJILLO ALTO",72139,1,1,0,0,0,0,0,0,0,0,1,1,0,0,"FL M"
"OUTSIDE HOME STATE",88888,2,2,0,0,0,0,0,0,0,0,2,2,0,0,"FL M"
"OUTSIDE U.S.",99999,24,15,0,0,5,5,2,0,0,1,19,13,0,4,"FL M"
MADISON,1089,1,1,0,0,0,0,0,0,0,0,1,1,0,0,"FL N"
ALACHUA,12001,289,244,0,1,44,10,9,0,1,0,279,235,0,44,"FL N"
BAY,12005,368,296,11,1,60,27,15,10,1,1,341,281,1,59,"FL N"
CALHOUN,12013,11,4,0,0,7,0,0,0,0,0,11,4,0,7,"FL N"
COLUMBIA,12023,1,1,0,0,0,0,0,0,0,0,1,1,0,0,"FL N"
DIXIE,12029,17,16,1,0,0,1,0,1,0,0,16,16,0,0,"FL N"
DUVAL,12031,2,2,0,0,0,0,0,0,0,0,2,2,0,0,"FL N"
ESCAMBIA,12033,610,482,3,0,125,16,12,3,0,1,594,470,0,124,"FL N"
FRANKLIN,12037,16,12,3,0,1,6,2,3,0,1,10,10,0,0,"FL N"
GADSDEN,12039,92,52,2,1,37,3,0,2,1,0,89,52,0,37,"FL N"
GILCHRIST,12041,15,15,0,0,0,2,2,0,0,0,13,13,0,0,"FL N"
GULF,12045,16,13,0,0,3,2,2,0,0,0,14,11,0,3,"FL N"
HOLMES,12059,15,13,0,0,2,0,0,0,0,0,15,13,0,2,"FL N"
JACKSON,12063,140,108,1,0,31,10,8,0,0,2,130,100,1,29,"FL N"
JEFFERSON,12065,21,17,0,0,4,0,0,0,0,0,21,17,0,4,"FL N"
LAFAYETTE,12067,4,2,0,0,2,0,0,0,0,0,4,2,0,2,"FL N"
LEON,12073,438,332,16,1,89,47,33,13,1,0,391,299,3,89,"FL N"
LEVY,12075,51,46,0,0,5,5,5,0,0,0,46,41,0,5,"FL N"
LIBERTY,12077,6,6,0,0,0,0,0,0,0,0,6,6,0,0,"FL N"
MADISON,12079,22,8,0,0,14,1,1,0,0,0,21,7,0,14,"FL N"
OKALOOSA,12091,320,284,1,0,35,16,14,1,0,1,304,270,0,34,"FL N"
"PALM BEACH",12099,3,0,2,0,1,2,0,2,0,0,1,0,0,1,"FL N"
"SANTA ROSA",12113,311,272,3,0,36,12,9,3,0,0,299,263,0,36,"FL N"
SUWANNEE,12121,2,2,0,0,0,0,0,0,0,0,2,2,0,0,"FL N"
TAYLOR,12123,20,13,0,0,7,0,0,0,0,0,20,13,0,7,"FL N"
WAKULLA,12129,52,36,0,0,16,1,1,0,0,0,51,35,0,16,"FL N"
WALTON,12131,94,78,3,0,13,8,6,2,0,0,86,72,1,13,"FL N"
WASHINGTON,12133,60,48,0,0,12,3,3,0,0,0,57,45,0,12,"FL N"
CHEROKEE,13057,1,1,0,0,0,0,0,0,0,0,1,1,0,0,"FL N"
COBB,13067,1,0,0,0,1,0,0,0,0,0,1,0,0,1,"FL N"
COOK,13075,1,1,0,0,0,0,0,0,0,0,1,1,0,0,"FL N"
RICHMOND,13245,1,1,0,0,0,0,0,0,0,0,1,1,0,0,"FL N"
DICKINSON,26043,1,1,0,0,0,0,0,0,0,0,1,1,0,0,"FL N"
CHESTER,42029,1,1,0,0,0,0,0,0,0,0,1,1,0,0,"FL N"
WESTMORELAND,42129,1,1,0,0,0,0,0,0,0,0,1,1,0,0,"FL N"
GREENVILLE,45045,1,1,0,0,0,0,0,0,0,0,1,1,0,0,"FL N"
SHELBY,47157,1,0,0,0,1,0,0,0,0,0,1,0,0,1,"FL N"
CULPEPER,51047,1,1,0,0,0,0,0,0,0,0,1,1,0,0,"FL N"
"OUTSIDE HOME STATE",88888,1,1,0,0,0,0,0,0,0,0,1,1,0,0,"FL N"
ARAPAHOE,8005,1,0,0,0,1,0,0,0,0,0,1,0,0,1,"FL S"
BREVARD,12009,2,1,0,0,1,0,0,0,0,0,2,1,0,1,"FL S"
BROWARD,12011,7439,4104,75,0,3260,201,138,47,0,16,7238,3966,28,3244,"FL S"
DADE,12025,1,1,0,0,0,0,0,0,0,0,1,1,0,0,"FL S"
DUVAL,12031,1,0,0,0,1,0,0,0,0,0,1,0,0,1,"FL S"
FLAGLER,12035,1,1,0,0,0,0,0,0,0,0,1,1,0,0,"FL S"
HERNANDO,12053,1,1,0,0,0,0,0,0,0,0,1,1,0,0,"FL S"
HIGHLANDS,12055,146,93,0,0,53,1,1,0,0,0,145,92,0,53,"FL S"
HILLSBOROUGH,12057,3,2,0,0,1,0,0,0,0,0,3,2,0,1,"FL S"
"INDIAN RIVER",12061,1046,725,13,0,308,25,17,6,0,2,1021,708,7,306,"FL S"
LEE,12071,2,0,0,0,2,0,0,0,0,0,2,0,0,2,"FL S"
MANATEE,12081,1,1,0,0,0,0,0,0,0,0,1,1,0,0,"FL S"
MARTIN,12085,306,195,3,0,108,9,7,2,0,0,297,188,1,108,"FL S"
MIAMI-DADE,12086,13169,7539,69,4,5557,263,179,57,4,23,12906,7360,12,5534,"FL S"
MONROE,12087,158,101,4,0,53,7,4,2,0,1,151,97,2,52,"FL S"
NASSAU,12089,1,1,0,0,0,0,0,0,0,0,1,1,0,0,"FL S"
OKEECHOBEE,12093,81,39,0,0,42,1,1,0,0,0,80,38,0,42,"FL S"
OSCEOLA,12097,1,1,0,0,0,0,0,0,0,0,1,1,0,0,"FL S"
"PALM BEACH",12099,4038,2372,78,2,1586,143,78,57,2,6,3895,2294,21,1580,"FL S"
PINELLAS,12103,1,1,0,0,0,0,0,0,0,0,1,1,0,0,"FL S"
POLK,12105,2,1,0,0,1,0,0,0,0,0,2,1,0,1,"FL S"
"ST. JOHNS",12109,1,1,0,0,0,0,0,0,0,0,1,1,0,0,"FL S"
"ST. LUCIE",12111,1375,831,11,0,533,27,15,10,0,2,1348,816,1,531,"FL S"
VOLUSIA,12127,1,1,0,0,0,0,0,0,0,0,1,1,0,0,"FL S"
FULTON,13121,2,0,1,0,1,1,0,1,0,0,1,0,0,1,"FL S"
GWINNETT,13135,2,1,0,0,1,0,0,0,0,0,2,1,0,1,"FL S"
SPALDING,13255,1,0,0,0,1,0,0,0,0,0,1,0,0,1,"FL S"
SUMTER,13261,1,0,0,0,1,0,0,0,0,0,1,0,0,1,"FL S"
"ANNE ARUNDEL",24003,1,0,0,0,1,0,0,0,0,0,1,0,0,1,"FL S"
CARROLL,24013,1,1,0,0,0,0,0,0,0,0,1,1,0,0,"FL S"
"PRINCE GEORGE'S",24033,1,1,0,0,0,0,0,0,0,0,1,1,0,0,"FL S"
WORCESTER,25027,1,0,1,0,0,1,0,1,0,0,0,0,0,0,"FL S"
MIDDLESEX,34023,1,0,0,0,1,0,0,0,0,0,1,0,0,1,"FL S"
UNION,34039,1,0,0,0,1,0,0,0,0,0,1,0,0,1,"FL S"
BRONX,36005,3,2,0,0,1,0,0,0,0,0,3,2,0,1,"FL S"
QUEENS,36081,3,0,0,0,3,0,0,0,0,0,3,0,0,3,"FL S"
SUFFOLK,36103,1,0,0,0,1,0,0,0,0,0,1,0,0,1,"FL S"
BURKE,37023,1,1,0,0,0,0,0,0,0,0,1,1,0,0,"FL S"
WAKE,37183,1,1,0,0,0,0,0,0,0,0,1,1,0,0,"FL S"
DELAWARE,39041,1,0,0,0,1,0,0,0,0,0,1,0,0,1,"FL S"
FRANKLIN,39049,1,1,0,0,0,0,0,0,0,0,1,1,0,0,"FL S"
MAHONING,39099,1,0,0,0,1,0,0,0,0,0,1,0,0,1,"FL S"
SUMMIT,39153,1,1,0,0,0,1,1,0,0,0,0,0,0,0,"FL S"
TRAVIS,48453,1,1,0,0,0,0,0,0,0,0,1,1,0,0,"FL S"
CHIPPEWA,55017,2,2,0,0,0,0,0,0,0,0,2,2,0,0,"FL S"
KENOSHA,55059,2,2,0,0,0,0,0,0,0,0,2,2,0,0,"FL S"
